TCTAAAGAACCGACCCTGA -> CTAAAGAACCGACCCTGAT
GGCTTTAGAGCTAAGTAGA -> GCTTTAGAGCTAAGTAGAT
GATGCAATGCCTTCGATGG -> ATGCAATGCCTTCGATGGC
ATGCAAGTACTGTGGCAAG -> TGCAAGTACTGTGGCAAGG
CGAGGTCGATAGCAAGAAA -> GAGGTCGATAGCAAGAAAC
TCTTGCCGGCCGTTAATCC -> CTTGCCGGCCGTTAATCCT
ATCCTCAGCGCGTCCGTCG -> TCCTCAGCGCGTCCGTCGA
GCGTCCGTCGACTATACCG -> CGTCCGTCGACTATACCGG
TGCGGCACCGACCTTTATA -> GCGGCACCGACCTTTATAG
GACTCGTCCAACCGCACGC -> ACTCGTCCAACCGCACGCC
CCACGTCCTCTTGTGGAGA -> CACGTCCTCTTGTGGAGAG
GACCTGGGACTGACGCCGC -> ACCTGGGACTGACGCCGCT
CACCGTAGGAAGCCAAGTT -> ACCGTAGGAAGCCAAGTTC
AGGTGTTACACACCGACCT -> GGTGTTACACACCGACCTG
ACATAACATAGGTCACCTA -> CATAACATAGGTCACCTAT
CCTTCTTAACGTTGTCACC -> CTTCTTAACGTTGTCACCG
TCCAGGACTAAGGGCTGGC -> CCAGGACTAAGGGCTGGCG
ACATTAGTAATGGAAGTAT -> CATTAGTAATGGAAGTATC
GACGTCCTGGCACAGGAAC -> ACGTCCTGGCACAGGAACT
CTGGCACAGGAACTAAGCG -> TGGCACAGGAACTAAGCGG
CAGGACTAAGGGCTGGCGA -> AGGACTAAGGGCTGGCGAT
TTTTCGTCCACTTGCTCAT -> TTTCGTCCACTTGCTCATC
GGAACTAAGGGAGAACAAA -> GAACTAAGGGAGAACAAAG
AACTGCGTGCGTACTCTGT -> ACTGCGTGCGTACTCTGTC
TCTGCGTATAGAACGGCGT -> CTGCGTATAGAACGGCGTT
CGCTTGTCTTGGACACGGC -> GCTTGTCTTGGACACGGCC
ACAGCTCGACGCGATCTTT -> CAGCTCGACGCGATCTTTT
TAGAACCACCCATTGCCCC -> AGAACCACCCATTGCCCCT
AACGACAATCAAAGCCCGA -> ACGACAATCAAAGCCCGAC
TCACTTAAACACCCCAAAT -> CACTTAAACACCCCAAATT
TTAAGCCGAGGTCGCTCCA -> TAAGCCGAGGTCGCTCCAG
CAGGGACAGTTAGCCGCGT -> AGGGACAGTTAGCCGCGTA
AGATCTTGGCAAGCAAGAT -> GATCTTGGCAAGCAAGATC
CAAGGATCACAATCACCGT -> AAGGATCACAATCACCGTC
ACAGGAACTAAGGGAGAAC -> CAGGAACTAAGGGAGAACA
CGGGCCAGCAGATAACCGC -> GGGCCAGCAGATAACCGCA
GCGCTTGTCTTGGACACGG -> CGCTTGTCTTGGACACGGC
ACCGTACATAACATAGGTC -> CCGTACATAACATAGGTCA
CAGTTAATCCAATTGTATT -> AGTTAATCCAATTGTATTC
CTGCTTGGGTGTATAATTT -> TGCTTGGGTGTATAATTTA
CACGTAGCCTTGATCATGG -> ACGTAGCCTTGATCATGGT
TAAGGGAGAACAAAGGGAC -> AAGGGAGAACAAAGGGACG
TTAGGCGCTCATACCGTAC -> TAGGCGCTCATACCGTACA
TAACGTTGTCACCGTAGGA -> AACGTTGTCACCGTAGGAA
GCATAGCATGTCCAGTGTA -> CATAGCATGTCCAGTGTAG
CCGACCCTGATGTTGGATC -> CGACCCTGATGTTGGATCC
CTTGCGAACTGCGTGCGTA -> TTGCGAACTGCGTGCGTAC
AACATATGTGCATAGCATG -> ACATATGTGCATAGCATGT
CACTTAAACACCCCAAATT -> ACTTAAACACCCCAAATTA
AGGTCGATAGCAAGAAACT -> GGTCGATAGCAAGAAACTT
CGTGTAATGCATCAATTAG -> GTGTAATGCATCAATTAGA
TGTCTTGGACACGGCCAGT -> GTCTTGGACACGGCCAGTC
TATAATTTATGTGGACAGT -> ATAATTTATGTGGACAGTC
TCTTCAGGCTGGGTCGGGT -> CTTCAGGCTGGGTCGGGTT
GGTTAGTGACCTTACCGCT -> GTTAGTGACCTTACCGCTG
CGTCTGGCCCGACCTTAAT -> GTCTGGCCCGACCTTAATC
GTGGGCAGTTCCTGGCGAA -> TGGGCAGTTCCTGGCGAAA
GACCTTAATCCTTACACGA -> ACCTTAATCCTTACACGAA
TCGACGCGATCTTTTGCAA -> CGACGCGATCTTTTGCAAC
GCGCCGTGCGGTCACATTT -> CGCCGTGCGGTCACATTTT
GTTCCTGGCGAAATATACG -> TTCCTGGCGAAATATACGA
AGTGTCCTCTGACTACATA -> GTGTCCTCTGACTACATAG
CGCTCCAGGACTAAGGGCT -> GCTCCAGGACTAAGGGCTG
GGCGCTTGTCTTGCCGGCC -> GCGCTTGTCTTGCCGGCCG
GAGGTGCATATCTTTAAAC -> AGGTGCATATCTTTAAACT
TGATTCGTACGGCATGTCG -> GATTCGTACGGCATGTCGA
CTTTAAACTGGACAAGCCT -> TTTAAACTGGACAAGCCTC
AGGGACAGTTAGCCGCGTA -> GGGACAGTTAGCCGCGTAA
ACTAGTCTTCAGGCTGGGT -> CTAGTCTTCAGGCTGGGTC
TTGTCACCGTAGGAAGCCA -> TGTCACCGTAGGAAGCCAA
ACCCCAAATTATCCTGGCA -> CCCCAAATTATCCTGGCAT
CGCCCATTACCGCTTTACG -> GCCCATTACCGCTTTACGG
AATGTACGGGCCAGCAGAT -> ATGTACGGGCCAGCAGATA
TTGGGTGTATAATTTATGT -> TGGGTGTATAATTTATGTG
ACTACATAGGGTAGATCCT -> CTACATAGGGTAGATCCTG
AAGCAAGATCGCACCAGGT -> AGCAAGATCGCACCAGGTG
AAAGATGGTCATTCCTGGC -> AAGATGGTCATTCCTGGCC
GTCTGCAGTGTCCTCTGAC -> TCTGCAGTGTCCTCTGACT
GCGGGTCTGCAGTGTCCTC -> CGGGTCTGCAGTGTCCTCT
ACGCCGACGAATACCGAAA -> CGCCGACGAATACCGAAAG
CGGTTACGCGGGTCTGCAG -> GGTTACGCGGGTCTGCAGT
GAGGTGTATTCAACAATGT -> AGGTGTATTCAACAATGTA
TAATTAGGCGCTCATACCG -> AATTAGGCGCTCATACCGT
AATCCGGTGATAGGATCCC -> ATCCGGTGATAGGATCCCC
AGCTGGGGGAGCAACTTAA -> GCTGGGGGAGCAACTTAAA
TCTTAAGTCGTCCAGATCC -> CTTAAGTCGTCCAGATCCC
CTCGGCGGTCCAAATACCC -> TCGGCGGTCCAAATACCCT
TATCGGCTCCACGTCCTCT -> ATCGGCTCCACGTCCTCTT
ACTGTCATTCACCAGCGAA -> CTGTCATTCACCAGCGAAA
TCTCATTTTCGTCCACTTG -> CTCATTTTCGTCCACTTGC
TTATGTGGACAGTCGTGGC -> TATGTGGACAGTCGTGGCC
CTTCTATATCCGTAGGCGC -> TTCTATATCCGTAGGCGCT
CCGCACGCCGACGAATACC -> CGCACGCCGACGAATACCG
GCATCTTCCGACGATCTTG -> CATCTTCCGACGATCTTGC
TGGAGAGCGGCGATTCGTG -> GGAGAGCGGCGATTCGTGT
AAGACTAGTCTTCAGGCTG -> AGACTAGTCTTCAGGCTGG
ATCATGGTGCTAGGAAATA -> TCATGGTGCTAGGAAATAG
TTCATGGTCCTTCTATATC -> TCATGGTCCTTCTATATCC
CCGTTGGTGTCTGATACTC -> CGTTGGTGTCTGATACTCA
GCAACCGAGGTGTATTCAA -> CAACCGAGGTGTATTCAAC
GTGGACAGTCGTGGCCGTA -> TGGACAGTCGTGGCCGTAC
CAACCGTAGGCGCTTGTCT -> AACCGTAGGCGCTTGTCTT
ATAACCGCACTAGGACAGC -> TAACCGCACTAGGACAGCT
GGGACTGTGTAGGCTATCT -> GGACTGTGTAGGCTATCTC
GTAGGCGCTTGTCTTGCCG -> TAGGCGCTTGTCTTGCCGG
TATCTCTCGAAACGGTTCA -> ATCTCTCGAAACGGTTCAA
AAGCCCGACCTACACACCG -> AGCCCGACCTACACACCGT
CGTCACTTAAACACCCCAA -> GTCACTTAAACACCCCAAA
GCTTTACGGGAGGATTCCG -> CTTTACGGGAGGATTCCGC
TTGGTTAGTGACCTTACCG -> TGGTTAGTGACCTTACCGC
TTAAGTCGTCCAGATCCCT -> TAAGTCGTCCAGATCCCTG
GCACGCCGACGAATACCGA -> CACGCCGACGAATACCGAA
AGGCGCTCATACCGTACAT -> GGCGCTCATACCGTACATA
GAGCGTCACTTAAACACCC -> AGCGTCACTTAAACACCCC
CCAGTCTAGTGGCTGCACG -> CAGTCTAGTGGCTGCACGC
GCAATGCCTTCGATGGCGG -> CAATGCCTTCGATGGCGGA
CTGATGTTGGATCCTTGCG -> TGATGTTGGATCCTTGCGA
GGTTTAGGTGCAACCGAGG -> GTTTAGGTGCAACCGAGGT
CCTGGCACAGGAACTAAGC -> CTGGCACAGGAACTAAGCG
GAACTAAGCGGGGCTTCCT -> AACTAAGCGGGGCTTCCTG
AGGAAGCCAAGTTCGGGAC -> GGAAGCCAAGTTCGGGACT
TCGGAGTAGATCTTGGCAA -> CGGAGTAGATCTTGGCAAG
TTCCTGGCGAAATATACGA -> TCCTGGCGAAATATACGAA
CGTAGGCGCTTGTCTTGCC -> GTAGGCGCTTGTCTTGCCG
TAAGCGGGGCTTCCTGGCA -> AAGCGGGGCTTCCTGGCAC
CCCTCGCAAGAAAGACTCG -> CCTCGCAAGAAAGACTCGT
TCGTCCAGATCCCTGCAAC -> CGTCCAGATCCCTGCAACA
CATGTCGACGTATAGGTTT -> ATGTCGACGTATAGGTTTG
GGATCCTTGCGAACTGCGT -> GATCCTTGCGAACTGCGTG
GCGTAACATTAGTAATGGA -> CGTAACATTAGTAATGGAA
AGCCTCTCGGAGTAGATCT -> GCCTCTCGGAGTAGATCTT
TGCATCAATTAGAGGTGCA -> GCATCAATTAGAGGTGCAT
GACAGGCAACCGTAGGCGC -> ACAGGCAACCGTAGGCGCT
ATAGCAAGAAACTTGGTTA -> TAGCAAGAAACTTGGTTAG
CCTTGTAATGCCCTCCGAA -> CTTGTAATGCCCTCCGAAT
CTGCGTATAGAACGGCGTT -> TGCGTATAGAACGGCGTTG
TTTTCCTGTACTCAGGCCG -> TTTCCTGTACTCAGGCCGT
TATGTGGACAGTCGTGGCC -> ATGTGGACAGTCGTGGCCG
CCTGGCGAAATATACGAAA -> CTGGCGAAATATACGAAAC
CCGACGAATACCGAAAGGA -> CGACGAATACCGAAAGGAG
TATCCTGGCATCTTCCGAC -> ATCCTGGCATCTTCCGACG
GGTTAGCACCTCCATGACC -> GTTAGCACCTCCATGACCC
GCCTTCGATGGCGGACCAC -> CCTTCGATGGCGGACCACC
AAATGGAACTGTCATTCAC -> AATGGAACTGTCATTCACC
GCACAGGAACTAAGGAACC -> CACAGGAACTAAGGAACCC
CGCCCAAAGATGGTCATTC -> GCCCAAAGATGGTCATTCC
GGCCGTGTAATGCATCAAT -> GCCGTGTAATGCATCAATT
GCCGCCAAGCATCTCATTT -> CCGCCAAGCATCTCATTTT
CGTATAGGTTTGATGGTTT -> GTATAGGTTTGATGGTTTA
GCCCTCCGAATTTGGACCA -> CCCTCCGAATTTGGACCAC
GACGAATACCGAAAGGAGT -> ACGAATACCGAAAGGAGTT
CCAATTGTATTCTGCCCCA -> CAATTGTATTCTGCCCCAC
ACGAAACAAGACTAGTCTT -> CGAAACAAGACTAGTCTTC
AGGACAGCTCGACGCGATC -> GGACAGCTCGACGCGATCT
CCGTCTGGCCCGACCTTAA -> CGTCTGGCCCGACCTTAAT
AGGGACGCGCCAGTCTAGT -> GGGACGCGCCAGTCTAGTG
TGGTGCTAGGAAATAGCCC -> GGTGCTAGGAAATAGCCCT
CAAAGGGACGCGCCAGTCT -> AAAGGGACGCGCCAGTCTA
CCCTCCGAATTTGGACCAC -> CCTCCGAATTTGGACCACA
TCATTTTCGTCCACTTGCT -> CATTTTCGTCCACTTGCTC
TATAGAACGGCGTTGAATG -> ATAGAACGGCGTTGAATGG
TGACGTCCTGGCACAGGAA -> GACGTCCTGGCACAGGAAC
GGCCTGATGGTGCACACCA -> GCCTGATGGTGCACACCAA
AAACTTGGTTAGTGACCTT -> AACTTGGTTAGTGACCTTA
GATGCAAGTACTGTGGCAA -> ATGCAAGTACTGTGGCAAG
GACTACATAGGGTAGATCC -> ACTACATAGGGTAGATCCT
TGCATTACCCCTCCTATTA -> GCATTACCCCTCCTATTAG
TAATCCGGTGATAGGATCC -> AATCCGGTGATAGGATCCC
CGTGCGTACTCTGTCTCTT -> GTGCGTACTCTGTCTCTTA
CCAGGGACAGTTAGCCGCG -> CAGGGACAGTTAGCCGCGT
GCCCTATCATGAGACCTTG -> CCCTATCATGAGACCTTGA
TCCTCTGACTACATAGGGT -> CCTCTGACTACATAGGGTA
GTCACTTAAACACCCCAAA -> TCACTTAAACACCCCAAAT
ACGGACTGCCCTGCTTGGG -> CGGACTGCCCTGCTTGGGT
CTTCCGACGATCTTGCATT -> TTCCGACGATCTTGCATTA
TCACATTTTTCCTGTACTC -> CACATTTTTCCTGTACTCA
CCGCTAGCGTGTCGGCTGC -> CGCTAGCGTGTCGGCTGCG
CTGACGCCGCTCAGGCCAT -> TGACGCCGCTCAGGCCATA
GGAAGTATCTGTGCACAAA -> GAAGTATCTGTGCACAAAT
GCGAACTGCGTGCGTACTC -> CGAACTGCGTGCGTACTCT
TTATCCTGTGGGCAGTTCC -> TATCCTGTGGGCAGTTCCT
CTGATGGTGCACACCAAGA -> TGATGGTGCACACCAAGAC
TTGTCTTGCCGGCCGTTAA -> TGTCTTGCCGGCCGTTAAT
TTACACGAATATAGATTCA -> TACACGAATATAGATTCAT
TAGGCGCTTGTCTTGAGCC -> AGGCGCTTGTCTTGAGCCG
TATAGGTTTGATGGTTTAG -> ATAGGTTTGATGGTTTAGG
TCGATGGCGGACCACCTAG -> CGATGGCGGACCACCTAGA
CCGGCACCGTACGCAATTG -> CGGCACCGTACGCAATTGA
CACCGACGTGAGGGTATCG -> ACCGACGTGAGGGTATCGG
CGACGTATAGGTTTGATGG -> GACGTATAGGTTTGATGGT
TGCGTATAGAACGGCGTTG -> GCGTATAGAACGGCGTTGA
TTAGTGACCTTACCGCTGC -> TAGTGACCTTACCGCTGCG
ACCCTTATCTTGCCGCGCC -> CCCTTATCTTGCCGCGCCG
ACAAGCCTCTCGGAGTAGA -> CAAGCCTCTCGGAGTAGAT
TATCCGTAGGCGCTTGTCT -> ATCCGTAGGCGCTTGTCTT
ACGTATAGGTTTGATGGTT -> CGTATAGGTTTGATGGTTT
TGGGTGTATAATTTATGTG -> GGGTGTATAATTTATGTGG
GACGCGCCAGTCTAGTGGC -> ACGCGCCAGTCTAGTGGCT
CTTGATCATGGTGCTAGGA -> TTGATCATGGTGCTAGGAA
GCAACCGTAGGCGCTTGTC -> CAACCGTAGGCGCTTGTCT
CTGGCACAGGAACTAAGGT -> TGGCACAGGAACTAAGGTT
TAGACCTAAATGGAACTGT -> AGACCTAAATGGAACTGTC
AGCCGCGTAACATTAGTAA -> GCCGCGTAACATTAGTAAT
GTTACACACCGACCTGGGA -> TTACACACCGACCTGGGAC
CAGTGTAGACTTTTTGCAG -> AGTGTAGACTTTTTGCAGT
CTCAGAGACGTCGTTGGTT -> TCAGAGACGTCGTTGGTTA
ACGATCTTGCATTACCCCT -> CGATCTTGCATTACCCCTC
CAGAGACGTCGTTGGTTAG -> AGAGACGTCGTTGGTTAGC
GAGCTAAGTAGATACTCAG -> AGCTAAGTAGATACTCAGA
GGCACAGGAACTAAGCGGG -> GCACAGGAACTAAGCGGGG
CCAAGACCCCCGGCACCGT -> CAAGACCCCCGGCACCGTA
AGCGAAATCACGTAGCCTT -> GCGAAATCACGTAGCCTTG
TGGGACTGACGCCGCTCAG -> GGGACTGACGCCGCTCAGG
TTAGTAATGGAAGTATCTG -> TAGTAATGGAAGTATCTGT
GGCGGTAGACCTAAATGGA -> GCGGTAGACCTAAATGGAA
AGTGGCTGCACGCTACACC -> GTGGCTGCACGCTACACCG
GCAAGTACTGTGGCAAGGA -> CAAGTACTGTGGCAAGGAT
CCCAAATTATCCTGGCATC -> CCAAATTATCCTGGCATCT
AACAAAGGGACGCGCCAGT -> ACAAAGGGACGCGCCAGTC
TTCGATGCAATGCCTTCGA -> TCGATGCAATGCCTTCGAT
AACAATGTACGGGCCAGCA -> ACAATGTACGGGCCAGCAG
AGCGCGCGCCCATTACCGC -> GCGCGCGCCCATTACCGCT
TGTGTAGGCTATCTCTCGA -> GTGTAGGCTATCTCTCGAA
CAAAGATGGTCATTCCTGG -> AAAGATGGTCATTCCTGGC
TGTGAGCGTGACGTCCTGG -> GTGAGCGTGACGTCCTGGC
CCTCCTATTAGTCTTAAGT -> CTCCTATTAGTCTTAAGTC
CCATGACCCGTAGGCGCTT -> CATGACCCGTAGGCGCTTG
GCACCTCCATGACCCGTAG -> CACCTCCATGACCCGTAGG
AGGAAATAGCCCTGACCCT -> GGAAATAGCCCTGACCCTT
ATGGTAGGTGTCCAATTCA -> TGGTAGGTGTCCAATTCAA
TACCGAAAGGAGTTTATCC -> ACCGAAAGGAGTTTATCCT
ACCGACGTGAGGGTATCGG -> CCGACGTGAGGGTATCGGC
CAGGAACTAAGGAACCCTT -> AGGAACTAAGGAACCCTTC
ACTAAGCGGGGCTTCCTGG -> CTAAGCGGGGCTTCCTGGC
TGTGGGCAGTTCCTGGCGA -> GTGGGCAGTTCCTGGCGAA
CAATTGAGCGTCACTTAAA -> AATTGAGCGTCACTTAAAC
ATTTAATTGTATGCCCTAT -> TTTAATTGTATGCCCTATC
CGGGTCTGCAGTGTCCTCT -> GGGTCTGCAGTGTCCTCTG
TAGTGACCTTACCGCTGCG -> AGTGACCTTACCGCTGCGA
CTCAGGCCGTGTAATGCAT -> TCAGGCCGTGTAATGCATC
GGTCGGGTTCCGGCGGTAG -> GTCGGGTTCCGGCGGTAGA
TTGAATGGTTTTAAGCCGA -> TGAATGGTTTTAAGCCGAG
GAAGCCAAGTTCGGGACTG -> AAGCCAAGTTCGGGACTGT
ACGGCATGTCGACGTATAG -> CGGCATGTCGACGTATAGG
GTCCAGTGTAGACTTTTTG -> TCCAGTGTAGACTTTTTGC
ATACCCTCATCCAATGCCG -> TACCCTCATCCAATGCCGC
GTAGGTGTCCAATTCAACA -> TAGGTGTCCAATTCAACAG
TTGGATCCTTGCGAACTGC -> TGGATCCTTGCGAACTGCG
GGCGATTTAATTGTATGCC -> GCGATTTAATTGTATGCCC
CGTGCGGTCACATTTTTCC -> GTGCGGTCACATTTTTCCT
CTTCCTGGCACAGGAACTA -> TTCCTGGCACAGGAACTAA
CTGGCCCGACCTTAATCCT -> TGGCCCGACCTTAATCCTT
CCGCGGGCCTGATGGTGCA -> CGCGGGCCTGATGGTGCAC
GATCCTTGCGAACTGCGTG -> ATCCTTGCGAACTGCGTGC
AGGAACTAAGGGAGAACAA -> GGAACTAAGGGAGAACAAA
TTAGAGCTAAGTAGATACT -> TAGAGCTAAGTAGATACTC
CTATTAGTCTTAAGTCGTC -> TATTAGTCTTAAGTCGTCC
ACACCCTCTAAGCGTATTT -> CACCCTCTAAGCGTATTTG
GGTCACCTATTCGGTCTAA -> GTCACCTATTCGGTCTAAA
TCTTGCCGCGCCGTGCGGT -> CTTGCCGCGCCGTGCGGTC
GACCTAAATGGAACTGTCA -> ACCTAAATGGAACTGTCAT
GGACTGTGTAGGCTATCTC -> GACTGTGTAGGCTATCTCT
GCACAGGAACTAAGGTTAT -> CACAGGAACTAAGGTTATA
TAGAGCGCCGACAGGCAAC -> AGAGCGCCGACAGGCAACC
CGCGCCAGTCTAGTGGCTG -> GCGCCAGTCTAGTGGCTGC
GGACTGCCCTGCTTGGGTG -> GACTGCCCTGCTTGGGTGT
CGGTCCAAATACCCTCATC -> GGTCCAAATACCCTCATCC
GCGATCTTTTGCAACTGCA -> CGATCTTTTGCAACTGCAC
GCCCTTGTAATGCCCTCCG -> CCCTTGTAATGCCCTCCGA
CCCTCATCCAATGCCGCCA -> CCTCATCCAATGCCGCCAA
GTATAGGTTTGATGGTTTA -> TATAGGTTTGATGGTTTAG
GGTGTCCAATTCAACAGAC -> GTGTCCAATTCAACAGACG
GCCTCTCGGAGTAGATCTT -> CCTCTCGGAGTAGATCTTG
GATTCGTACGGCATGTCGA -> ATTCGTACGGCATGTCGAC
GATAACCGCACTAGGACAG -> ATAACCGCACTAGGACAGC
GGTAGATCCTGGACAGCAC -> GTAGATCCTGGACAGCACG
CTGGCACAGGAACTAAGGA -> TGGCACAGGAACTAAGGAA
CCGTAGGCGCTTGTCTTGT -> CGTAGGCGCTTGTCTTGTG
GAGGTCGATAGCAAGAAAC -> AGGTCGATAGCAAGAAACT
GGATTCCGCTAGCGTGTCG -> GATTCCGCTAGCGTGTCGG
GGCGCTTGTCTTGTGAGCG -> GCGCTTGTCTTGTGAGCGT
TAGATACTCAGAGACGTCG -> AGATACTCAGAGACGTCGT
AAACTGGACAAGCCTCTCG -> AACTGGACAAGCCTCTCGG
ACTAAGGTTATACCTCGGC -> CTAAGGTTATACCTCGGCG
ATTGAGCGTCACTTAAACA -> TTGAGCGTCACTTAAACAC
GTTGAATGGTTTTAAGCCG -> TTGAATGGTTTTAAGCCGA
AATAGCCCTGACCCTTATC -> ATAGCCCTGACCCTTATCT
TGCAGTGTCCTCTGACTAC -> GCAGTGTCCTCTGACTACA
TTCCCGACACCGCGGGCCT -> TCCCGACACCGCGGGCCTG
CGACGCGATCTTTTGCAAC -> GACGCGATCTTTTGCAACT
TGGTTTTAAGCCGAGGTCG -> GGTTTTAAGCCGAGGTCGC
CCAGGACTAAGGGCTGGCG -> CAGGACTAAGGGCTGGCGA
AGAGCTAAGTAGATACTCA -> GAGCTAAGTAGATACTCAG
GTTGGTGTCTGATACTCAG -> TTGGTGTCTGATACTCAGA
ACGGTTCAACTTGGACCAC -> CGGTTCAACTTGGACCACT
CCCCTCCTATTAGTCTTAA -> CCCTCCTATTAGTCTTAAG
CGGGTAAGTTCGATGCAAT -> GGGTAAGTTCGATGCAATG
TTGGACCACAGATCCATGA -> TGGACCACAGATCCATGAA
ACTCAGAGCTGGGGGAGCA -> CTCAGAGCTGGGGGAGCAA
CGACTATACCGGTTACGCG -> GACTATACCGGTTACGCGG
CCAACGACAATCAAAGCCC -> CAACGACAATCAAAGCCCG
GCCCGACCTACACACCGTT -> CCCGACCTACACACCGTTG
ACACACCGACCTGGGACTG -> CACACCGACCTGGGACTGA
CGACCTACACACCGTTGGT -> GACCTACACACCGTTGGTG
CACGAATATAGATTCATGG -> ACGAATATAGATTCATGGT
CACAATCACCGTCTGGCCC -> ACAATCACCGTCTGGCCCG
ATTACCGCTTTACGGGAGG -> TTACCGCTTTACGGGAGGA
GGCCCTCGCAAGAAAGACT -> GCCCTCGCAAGAAAGACTC
CTTAAGTCGTCCAGATCCC -> TTAAGTCGTCCAGATCCCT
TCGGGTTCCGGCGGTAGAC -> CGGGTTCCGGCGGTAGACC
ATTTATGTGGACAGTCGTG -> TTTATGTGGACAGTCGTGG
CCTCCGAATTTGGACCACA -> CTCCGAATTTGGACCACAG
TAATGCCCTCCGAATTTGG -> AATGCCCTCCGAATTTGGA
TAGGACAGCTCGACGCGAT -> AGGACAGCTCGACGCGATC
GCCATAGGTAATCCGGTGA -> CCATAGGTAATCCGGTGAT
TGCCCTGCGGCACCGACCT -> GCCCTGCGGCACCGACCTT
GGGCAGTTCCTGGCGAAAT -> GGCAGTTCCTGGCGAAATA
ACCTAAATGGAACTGTCAT -> CCTAAATGGAACTGTCATT
GGTTTTAAGCCGAGGTCGC -> GTTTTAAGCCGAGGTCGCT
GCGGACCACCTAGAACCAC -> CGGACCACCTAGAACCACC
GGGGCTTCCTGGCACAGGA -> GGGCTTCCTGGCACAGGAA
GCATATCTTTAAACTGGAC -> CATATCTTTAAACTGGACA
AACATAGGTCACCTATTCG -> ACATAGGTCACCTATTCGG
GCGAAATATACGAAACAAG -> CGAAATATACGAAACAAGA
ATACTCAGAGACGTCGTTG -> TACTCAGAGACGTCGTTGG
TCCGGCGGTAGACCTAAAT -> CCGGCGGTAGACCTAAATG
CGCGTAACATTAGTAATGG -> GCGTAACATTAGTAATGGA
CGAGGTGTATTCAACAATG -> GAGGTGTATTCAACAATGT
TGAGGGTATCGGCTCCACG -> GAGGGTATCGGCTCCACGT
TTATTTGCCCATGGTAGGT -> TATTTGCCCATGGTAGGTG
TAGAACGGCGTTGAATGGT -> AGAACGGCGTTGAATGGTT
TACCGGTTACGCGGGTCTG -> ACCGGTTACGCGGGTCTGC
TCACGTAGCCTTGATCATG -> CACGTAGCCTTGATCATGG
AGATCCATGAATGAAGACG -> GATCCATGAATGAAGACGC
TCCGACGATCTTGCATTAC -> CCGACGATCTTGCATTACC
CCGCGCCGTGCGGTCACAT -> CGCGCCGTGCGGTCACATT
CGAATATAGATTCATGGTC -> GAATATAGATTCATGGTCC
CCAAATACCCTCATCCAAT -> CAAATACCCTCATCCAATG
CGTATTTGGCCAACGACAA -> GTATTTGGCCAACGACAAT
GTAATCCGGTGATAGGATC -> TAATCCGGTGATAGGATCC
GACAGCACGTCACGTAGTC -> ACAGCACGTCACGTAGTCA
CTGCCCCACATTGCCCTTG -> TGCCCCACATTGCCCTTGT
AGCATGTCCAGTGTAGACT -> GCATGTCCAGTGTAGACTT
ATCGGCTCCACGTCCTCTT -> TCGGCTCCACGTCCTCTTG
TACTGTGGCAAGGATCACA -> ACTGTGGCAAGGATCACAA
TAAGCGTATTTGGCCAACG -> AAGCGTATTTGGCCAACGA
GTCGGCTGCGACTTGCCCT -> TCGGCTGCGACTTGCCCTG
GGATCCCCGAAACGTATGG -> GATCCCCGAAACGTATGGC
CAGCAGATAACCGCACTAG -> AGCAGATAACCGCACTAGG
GGTCATTCCTGGCCCTCGC -> GTCATTCCTGGCCCTCGCA
CCTCTTGTGGAGAGCGGCG -> CTCTTGTGGAGAGCGGCGA
CAGATAACCGCACTAGGAC -> AGATAACCGCACTAGGACA
TAGGAAATAGCCCTGACCC -> AGGAAATAGCCCTGACCCT
TTTCGTCCACTTGCTCATC -> TTCGTCCACTTGCTCATCC
CATCTTCCGACGATCTTGC -> ATCTTCCGACGATCTTGCA
CGACGATCTTGCATTACCC -> GACGATCTTGCATTACCCC
GTCACGTAGTCACGAGGTC -> TCACGTAGTCACGAGGTCG
ATTGCCCCTCGATGCAAGT -> TTGCCCCTCGATGCAAGTA
GGTGTATAATTTATGTGGA -> GTGTATAATTTATGTGGAC
TTACACACCGACCTGGGAC -> TACACACCGACCTGGGACT
TCCGCTAGCGTGTCGGCTG -> CCGCTAGCGTGTCGGCTGC
GGAAGCCAAGTTCGGGACT -> GAAGCCAAGTTCGGGACTG
AAGTAGATACTCAGAGACG -> AGTAGATACTCAGAGACGT
TCCATGAATGAAGACGCCC -> CCATGAATGAAGACGCCCG
GTTAGCACCTCCATGACCC -> TTAGCACCTCCATGACCCG
TGCACACCAAGACCCCCGG -> GCACACCAAGACCCCCGGC
GGTCACATTTTTCCTGTAC -> GTCACATTTTTCCTGTACT
CACAGGAACTAAGGTTATA -> ACAGGAACTAAGGTTATAC
GGCTGCGACTTGCCCTGCG -> GCTGCGACTTGCCCTGCGG
AATCTTAGAGCGCCGACAG -> ATCTTAGAGCGCCGACAGG
GCACGTCACGTAGTCACGA -> CACGTCACGTAGTCACGAG
ATCACGTAGCCTTGATCAT -> TCACGTAGCCTTGATCATG
ACACGAATATAGATTCATG -> CACGAATATAGATTCATGG
GTCCTTCTATATCCGTAGG -> TCCTTCTATATCCGTAGGC
TCCGTCGACTATACCGGTT -> CCGTCGACTATACCGGTTA
CAGCGCGTCCGTCGACTAT -> AGCGCGTCCGTCGACTATA
GTTGTCACCGTAGGAAGCC -> TTGTCACCGTAGGAAGCCA
GACGGACTGCCCTGCTTGG -> ACGGACTGCCCTGCTTGGG
TAGTGGCTGCACGCTACAC -> AGTGGCTGCACGCTACACC
TTTATAGCATAATTAGGCG -> TTATAGCATAATTAGGCGC
GACGCGATCTTTTGCAACT -> ACGCGATCTTTTGCAACTG
GGAGAGCGGCGATTCGTGT -> GAGAGCGGCGATTCGTGTC
AGTTTATCCTGTGGGCAGT -> GTTTATCCTGTGGGCAGTT
ATCTGGCGCGGGTAAGTTC -> TCTGGCGCGGGTAAGTTCG
TTAGCCGCGTAACATTAGT -> TAGCCGCGTAACATTAGTA
GGTTACGCGGGTCTGCAGT -> GTTACGCGGGTCTGCAGTG
TGGCACAGGAACTAAGGTT -> GGCACAGGAACTAAGGTTA
TGTCGACGTATAGGTTTGA -> GTCGACGTATAGGTTTGAT
CGTACTCTGTCTCTTATTT -> GTACTCTGTCTCTTATTTG
CTGTGTAGGCTATCTCTCG -> TGTGTAGGCTATCTCTCGA
GAGTTTATCCTGTGGGCAG -> AGTTTATCCTGTGGGCAGT
TCAGCGCGTCCGTCGACTA -> CAGCGCGTCCGTCGACTAT
CCTGGCCCTCGCAAGAAAG -> CTGGCCCTCGCAAGAAAGA
CCAGTCCTGGCACAGGAAC -> CAGTCCTGGCACAGGAACT
TCGGTCTAAAGAACCGACC -> CGGTCTAAAGAACCGACCC
AGACCTTGATTCGTACGGC -> GACCTTGATTCGTACGGCA
ACCCGTAGGCGCTTGTCTT -> CCCGTAGGCGCTTGTCTTG
TCAACAGACGGACTGCCCT -> CAACAGACGGACTGCCCTG
CGTGTCGGCTGCGACTTGC -> GTGTCGGCTGCGACTTGCC
CAACTTGGACCACTTGGCC -> AACTTGGACCACTTGGCCA
TGATACTCAGAGCTGGGGG -> GATACTCAGAGCTGGGGGA
GCATTACCCCTCCTATTAG -> CATTACCCCTCCTATTAGT
TATCTTTAAACTGGACAAG -> ATCTTTAAACTGGACAAGC
AACTAAGGTTATACCTCGG -> ACTAAGGTTATACCTCGGC
CGTAGTCACGAGGTCGATA -> GTAGTCACGAGGTCGATAG
CCGACCTTAATCCTTACAC -> CGACCTTAATCCTTACACG
TGTCTGGCTTAATCTTAGA -> GTCTGGCTTAATCTTAGAG
ACCGAAAGGAGTTTATCCT -> CCGAAAGGAGTTTATCCTG
GAAGACGCCCGCCCCGGTG -> AAGACGCCCGCCCCGGTGC
TGGAACTGTCATTCACCAG -> GGAACTGTCATTCACCAGC
CACAAATTTACACCCTCTA -> ACAAATTTACACCCTCTAA
GATTCATGGTCCTTCTATA -> ATTCATGGTCCTTCTATAT
ACCTACACACCGTTGGTGT -> CCTACACACCGTTGGTGTC
GTTCGGGACTGTGTAGGCT -> TTCGGGACTGTGTAGGCTA
AATGAAGACGCCCGCCCCG -> ATGAAGACGCCCGCCCCGG
GGACGCGCCAGTCTAGTGG -> GACGCGCCAGTCTAGTGGC
AGGACTAAGGGCTGGCGAT -> GGACTAAGGGCTGGCGATT
GCATGTCCAGTGTAGACTT -> CATGTCCAGTGTAGACTTT
CCAATGCCGCCAAGCATCT -> CAATGCCGCCAAGCATCTC
CGAGGTCGCTCCAGGACTA -> GAGGTCGCTCCAGGACTAA
GGGACGCGCCAGTCTAGTG -> GGACGCGCCAGTCTAGTGG
TTGTGGAGAGCGGCGATTC -> TGTGGAGAGCGGCGATTCG
TGAGACCTTGATTCGTACG -> GAGACCTTGATTCGTACGG
GATTCCGCTAGCGTGTCGG -> ATTCCGCTAGCGTGTCGGC
CGATCTTGCATTACCCCTC -> GATCTTGCATTACCCCTCC
TTGCAGTTAATCCAATTGT -> TGCAGTTAATCCAATTGTA
AGATCGCACCAGGTGGCTT -> GATCGCACCAGGTGGCTTT
TCAGAGACGTCGTTGGTTA -> CAGAGACGTCGTTGGTTAG
AGTCTAGTGGCTGCACGCT -> GTCTAGTGGCTGCACGCTA
TCTAAGCGTATTTGGCCAA -> CTAAGCGTATTTGGCCAAC
CGTATAGAACGGCGTTGAA -> GTATAGAACGGCGTTGAAT
GATCCCCGAAACGTATGGC -> ATCCCCGAAACGTATGGCT
ACAGATCCATGAATGAAGA -> CAGATCCATGAATGAAGAC
AGTGTAGACTTTTTGCAGT -> GTGTAGACTTTTTGCAGTT
CCATGGTAGGTGTCCAATT -> CATGGTAGGTGTCCAATTC
CTGGCGCGGGTAAGTTCGA -> TGGCGCGGGTAAGTTCGAT
TACTCAGAGCTGGGGGAGC -> ACTCAGAGCTGGGGGAGCA
CCGAAACGTATGGCTCTGC -> CGAAACGTATGGCTCTGCG
GAGTAGATCTTGGCAAGCA -> AGTAGATCTTGGCAAGCAA
AACGTATGGCTCTGCGTAT -> ACGTATGGCTCTGCGTATA
AATGGAAGTATCTGTGCAC -> ATGGAAGTATCTGTGCACA
CAGGCAACCGTAGGCGCTT -> AGGCAACCGTAGGCGCTTG
TCATCCAAGCGCGCGCCCA -> CATCCAAGCGCGCGCCCAT
GCTCATCCAAGCGCGCGCC -> CTCATCCAAGCGCGCGCCC
AGATTCATGGTCCTTCTAT -> GATTCATGGTCCTTCTATA
AACTAAGGAACCCTTCTTA -> ACTAAGGAACCCTTCTTAA
GTCGTGGCCGTACATATCC -> TCGTGGCCGTACATATCCT
GAGCGCCGACAGGCAACCG -> AGCGCCGACAGGCAACCGT
GTCCAAATACCCTCATCCA -> TCCAAATACCCTCATCCAA
GTCACCGTAGGAAGCCAAG -> TCACCGTAGGAAGCCAAGT
ATGCCCTCCGAATTTGGAC -> TGCCCTCCGAATTTGGACC
AATTTACACCCTCTAAGCG -> ATTTACACCCTCTAAGCGT
GATGGCGGACCACCTAGAA -> ATGGCGGACCACCTAGAAC
GTAGATCCTGGACAGCACG -> TAGATCCTGGACAGCACGT
CTAAATGGAACTGTCATTC -> TAAATGGAACTGTCATTCA
TTACGGGAGGATTCCGCTA -> TACGGGAGGATTCCGCTAG
CCCTATCATGAGACCTTGA -> CCTATCATGAGACCTTGAT
GTTTATCCTGTGGGCAGTT -> TTTATCCTGTGGGCAGTTC
CTGCGACTTGCCCTGCGGC -> TGCGACTTGCCCTGCGGCA
CCAAATTATCCTGGCATCT -> CAAATTATCCTGGCATCTT
ACTTTTTGCAGTTAATCCA -> CTTTTTGCAGTTAATCCAA
CATATCTTTAAACTGGACA -> ATATCTTTAAACTGGACAA
AGGCTATCTCTCGAAACGG -> GGCTATCTCTCGAAACGGT
GGGCCTGATGGTGCACACC -> GGCCTGATGGTGCACACCA
TTTAAGCCGAGGTCGCTCC -> TTAAGCCGAGGTCGCTCCA
CATGGTCCTTCTATATCCG -> ATGGTCCTTCTATATCCGT
GCACAGGAACTAAGCGGGG -> CACAGGAACTAAGCGGGGC
TTTTGCAGTTAATCCAATT -> TTTGCAGTTAATCCAATTG
CTTAAACACCCCAAATTAT -> TTAAACACCCCAAATTATC
GTCGACTATACCGGTTACG -> TCGACTATACCGGTTACGC
CGTCGTTGGTTAGCACCTC -> GTCGTTGGTTAGCACCTCC
CGAAACGGTTCAACTTGGA -> GAAACGGTTCAACTTGGAC
ATTTACACCCTCTAAGCGT -> TTTACACCCTCTAAGCGTA
CCTTTATAGCATAATTAGG -> CTTTATAGCATAATTAGGC
GGGTCTGCAGTGTCCTCTG -> GGTCTGCAGTGTCCTCTGA
GTAGGCGCTTGTCTTGTGA -> TAGGCGCTTGTCTTGTGAG
ATCCCTGCAACATATGTGC -> TCCCTGCAACATATGTGCA
GCGCTTGTCTTGTGAGCGT -> CGCTTGTCTTGTGAGCGTG
AGCCAAGTTCGGGACTGTG -> GCCAAGTTCGGGACTGTGT
CCGTAGGAAGCCAAGTTCG -> CGTAGGAAGCCAAGTTCGG
ACCGCACGCCGACGAATAC -> CCGCACGCCGACGAATACC
TCACGAGGTCGATAGCAAG -> CACGAGGTCGATAGCAAGA
GGCGATTCGTGTCTGGCTT -> GCGATTCGTGTCTGGCTTA
GTGCATAGCATGTCCAGTG -> TGCATAGCATGTCCAGTGT
TGGCTGCACGCTACACCGA -> GGCTGCACGCTACACCGAC
CATTACCCCTCCTATTAGT -> ATTACCCCTCCTATTAGTC
GTAGGCTATCTCTCGAAAC -> TAGGCTATCTCTCGAAACG
ATTGTATGCCCTATCATGA -> TTGTATGCCCTATCATGAG
CGATAGCAAGAAACTTGGT -> GATAGCAAGAAACTTGGTT
AGTTCGGGACTGTGTAGGC -> GTTCGGGACTGTGTAGGCT
CACTTTACCTCGACATCTG -> ACTTTACCTCGACATCTGG
CGCTTGTCTTGAGCCGCCG -> GCTTGTCTTGAGCCGCCGT
AGAGACGTCGTTGGTTAGC -> GAGACGTCGTTGGTTAGCA
GACATCTGGCGCGGGTAAG -> ACATCTGGCGCGGGTAAGT
AAACACCCCAAATTATCCT -> AACACCCCAAATTATCCTG
TCGGCGGTCCAAATACCCT -> CGGCGGTCCAAATACCCTC
TGCGGTCACATTTTTCCTG -> GCGGTCACATTTTTCCTGT
AGACTTTTTGCAGTTAATC -> GACTTTTTGCAGTTAATCC
ACTGCCCTGCTTGGGTGTA -> CTGCCCTGCTTGGGTGTAT
TGTACTCAGGCCGTGTAAT -> GTACTCAGGCCGTGTAATG
TTATAGCATAATTAGGCGC -> TATAGCATAATTAGGCGCT
TCACCTATTCGGTCTAAAG -> CACCTATTCGGTCTAAAGA
GGGACTGACGCCGCTCAGG -> GGACTGACGCCGCTCAGGC
GAGACCTTGATTCGTACGG -> AGACCTTGATTCGTACGGC
TCTTGGACACGGCCAGTCC -> CTTGGACACGGCCAGTCCT
GTAGGAAGCCAAGTTCGGG -> TAGGAAGCCAAGTTCGGGA
ATACCGTACATAACATAGG -> TACCGTACATAACATAGGT
TTCCGGCGGTAGACCTAAA -> TCCGGCGGTAGACCTAAAT
GGGTAGATCCTGGACAGCA -> GGTAGATCCTGGACAGCAC
TCTGGCTTAATCTTAGAGC -> CTGGCTTAATCTTAGAGCG
GTCTTCAGGCTGGGTCGGG -> TCTTCAGGCTGGGTCGGGT
GGTGTATTCAACAATGTAC -> GTGTATTCAACAATGTACG
GGTGCATATCTTTAAACTG -> GTGCATATCTTTAAACTGG
CCTCCATGACCCGTAGGCG -> CTCCATGACCCGTAGGCGC
CACTTGCTCATCCAAGCGC -> ACTTGCTCATCCAAGCGCG
GCCCATGGTAGGTGTCCAA -> CCCATGGTAGGTGTCCAAT
CCCTCGATGCAAGTACTGT -> CCTCGATGCAAGTACTGTG
CACCAAGACCCCCGGCACC -> ACCAAGACCCCCGGCACCG
CCCGACCTTAATCCTTACA -> CCGACCTTAATCCTTACAC
GCTTGTCTTGAGCCGCCGT -> CTTGTCTTGAGCCGCCGTA
ACCCCCGGCACCGTACGCA -> CCCCCGGCACCGTACGCAA
AGTTCGATGCAATGCCTTC -> GTTCGATGCAATGCCTTCG
CCTTCTATATCCGTAGGCG -> CTTCTATATCCGTAGGCGC
GTCCAACCGCACGCCGACG -> TCCAACCGCACGCCGACGA
TAAACTGGACAAGCCTCTC -> AAACTGGACAAGCCTCTCG
CCCGGTGCCAGCAGGTGTT -> CCGGTGCCAGCAGGTGTTA
ATTGCCCTTGTAATGCCCT -> TTGCCCTTGTAATGCCCTC
TGCCCTTGTAATGCCCTCC -> GCCCTTGTAATGCCCTCCG
GATCCATGAATGAAGACGC -> ATCCATGAATGAAGACGCC
AGTTCCTGGCGAAATATAC -> GTTCCTGGCGAAATATACG
ACTAGGACAGCTCGACGCG -> CTAGGACAGCTCGACGCGA
CATTTTCGTCCACTTGCTC -> ATTTTCGTCCACTTGCTCA
GGCGCTTGTCTTGAGCCGC -> GCGCTTGTCTTGAGCCGCC
CTCATCCAAGCGCGCGCCC -> TCATCCAAGCGCGCGCCCA
GTCGACGTATAGGTTTGAT -> TCGACGTATAGGTTTGATG
TCGCACCAGGTGGCTTTAG -> CGCACCAGGTGGCTTTAGA
TGTCATTCACCAGCGAAAT -> GTCATTCACCAGCGAAATC
CAACAATGTACGGGCCAGC -> AACAATGTACGGGCCAGCA
GCCGTACATATCCTATCCT -> CCGTACATATCCTATCCTC
CCGACCTACACACCGTTGG -> CGACCTACACACCGTTGGT
CTGATACTCAGAGCTGGGG -> TGATACTCAGAGCTGGGGG
ACGTCGTTGGTTAGCACCT -> CGTCGTTGGTTAGCACCTC
CTGGCTTAATCTTAGAGCG -> TGGCTTAATCTTAGAGCGC
TTCGCCCAAAGATGGTCAT -> TCGCCCAAAGATGGTCATT
TGGCTTAATCTTAGAGCGC -> GGCTTAATCTTAGAGCGCC
GCCCTGCTTGGGTGTATAA -> CCCTGCTTGGGTGTATAAT
TCTGCAGTGTCCTCTGACT -> CTGCAGTGTCCTCTGACTA
ACCACCCATTGCCCCTCGA -> CCACCCATTGCCCCTCGAT
TTAGTCTTAAGTCGTCCAG -> TAGTCTTAAGTCGTCCAGA
TCTTGAGCCGCCGTAGGCG -> CTTGAGCCGCCGTAGGCGC
ACAAGACTAGTCTTCAGGC -> CAAGACTAGTCTTCAGGCT
GGACCACTTGGCCAGGGAC -> GACCACTTGGCCAGGGACA
TCTATATCCGTAGGCGCTT -> CTATATCCGTAGGCGCTTG
AAGCCTCTCGGAGTAGATC -> AGCCTCTCGGAGTAGATCT
TCCCTGCAACATATGTGCA -> CCCTGCAACATATGTGCAT
TGTCCTCTGACTACATAGG -> GTCCTCTGACTACATAGGG
TCCTATTAGTCTTAAGTCG -> CCTATTAGTCTTAAGTCGT
CGTAGGAAGCCAAGTTCGG -> GTAGGAAGCCAAGTTCGGG
CCTCTAAGCGTATTTGGCC -> CTCTAAGCGTATTTGGCCA
CATAATTAGGCGCTCATAC -> ATAATTAGGCGCTCATACC
GACCACTTGGCCAGGGACA -> ACCACTTGGCCAGGGACAG
CAATTGTATTCTGCCCCAC -> AATTGTATTCTGCCCCACA
CCTAAATGGAACTGTCATT -> CTAAATGGAACTGTCATTC
AGATAACCGCACTAGGACA -> GATAACCGCACTAGGACAG
ACACCAAGACCCCCGGCAC -> CACCAAGACCCCCGGCACC
CTTGGTTAGTGACCTTACC -> TTGGTTAGTGACCTTACCG
GGCACCGTACGCAATTGAG -> GCACCGTACGCAATTGAGC
CGGCACCGACCTTTATAGC -> GGCACCGACCTTTATAGCA
CCAATTCAACAGACGGACT -> CAATTCAACAGACGGACTG
CGCCGTAGGCGCTTGTCTT -> GCCGTAGGCGCTTGTCTTG
CACCGACCTGGGACTGACG -> ACCGACCTGGGACTGACGC
ACGTCCTGGCACAGGAACT -> CGTCCTGGCACAGGAACTA
GGAGAACAAAGGGACGCGC -> GAGAACAAAGGGACGCGCC
GATCTTTTGCAACTGCACT -> ATCTTTTGCAACTGCACTT
GGCCATAGGTAATCCGGTG -> GCCATAGGTAATCCGGTGA
TAAGCCGAGGTCGCTCCAG -> AAGCCGAGGTCGCTCCAGG
CTCTGTCTCTTATTTGCCC -> TCTGTCTCTTATTTGCCCA
GTGCCAGCAGGTGTTACAC -> TGCCAGCAGGTGTTACACA
CAAATACCCTCATCCAATG -> AAATACCCTCATCCAATGC
AACTGTCATTCACCAGCGA -> ACTGTCATTCACCAGCGAA
CAGATCCCTGCAACATATG -> AGATCCCTGCAACATATGT
CATGAGACCTTGATTCGTA -> ATGAGACCTTGATTCGTAC
CCTCGACATCTGGCGCGGG -> CTCGACATCTGGCGCGGGT
TCCTCTTGTGGAGAGCGGC -> CCTCTTGTGGAGAGCGGCG
TTTAGGTGCAACCGAGGTG -> TTAGGTGCAACCGAGGTGT
CTCTCGAAACGGTTCAACT -> TCTCGAAACGGTTCAACTT
CATGTCCAGTGTAGACTTT -> ATGTCCAGTGTAGACTTTT
ACTTTACCTCGACATCTGG -> CTTTACCTCGACATCTGGC
TTCCGCTAGCGTGTCGGCT -> TCCGCTAGCGTGTCGGCTG
TAACCGCACTAGGACAGCT -> AACCGCACTAGGACAGCTC
CCGCCAAGCATCTCATTTT -> CGCCAAGCATCTCATTTTC
TTGATTCGTACGGCATGTC -> TGATTCGTACGGCATGTCG
AGAGCGGCGATTCGTGTCT -> GAGCGGCGATTCGTGTCTG
CAAGCGCGCGCCCATTACC -> AAGCGCGCGCCCATTACCG
ATTCCGCTAGCGTGTCGGC -> TTCCGCTAGCGTGTCGGCT
ATTTTTCCTGTACTCAGGC -> TTTTTCCTGTACTCAGGCC
TGCCGCCAAGCATCTCATT -> GCCGCCAAGCATCTCATTT
ATCCATGAATGAAGACGCC -> TCCATGAATGAAGACGCCC
TTGCCCATGGTAGGTGTCC -> TGCCCATGGTAGGTGTCCA
TCATTCACCAGCGAAATCA -> CATTCACCAGCGAAATCAC
AATGCCTTCGATGGCGGAC -> ATGCCTTCGATGGCGGACC
CCTGATGGTGCACACCAAG -> CTGATGGTGCACACCAAGA
TGTCCAATTCAACAGACGG -> GTCCAATTCAACAGACGGA
AGCCTTGATCATGGTGCTA -> GCCTTGATCATGGTGCTAG
AATTGTATGCCCTATCATG -> ATTGTATGCCCTATCATGA
TTGGACCACTTGGCCAGGG -> TGGACCACTTGGCCAGGGA
CGGAGTAGATCTTGGCAAG -> GGAGTAGATCTTGGCAAGC
AAAGACTCGTCCAACCGCA -> AAGACTCGTCCAACCGCAC
ATCACCGTCTGGCCCGACC -> TCACCGTCTGGCCCGACCT
GCTATCTCTCGAAACGGTT -> CTATCTCTCGAAACGGTTC
ACGAGGTCGATAGCAAGAA -> CGAGGTCGATAGCAAGAAA
AGGATCCCCGAAACGTATG -> GGATCCCCGAAACGTATGG
TAAGGTTATACCTCGGCGG -> AAGGTTATACCTCGGCGGT
ATCTTAGAGCGCCGACAGG -> TCTTAGAGCGCCGACAGGC
ACGCAATTGAGCGTCACTT -> CGCAATTGAGCGTCACTTA
TTCCGACGATCTTGCATTA -> TCCGACGATCTTGCATTAC
CGACCTGGGACTGACGCCG -> GACCTGGGACTGACGCCGC
TGGTCCTTCTATATCCGTA -> GGTCCTTCTATATCCGTAG
CAATCACCGTCTGGCCCGA -> AATCACCGTCTGGCCCGAC
CTCATCCAATGCCGCCAAG -> TCATCCAATGCCGCCAAGC
CACTTGGCCAGGGACAGTT -> ACTTGGCCAGGGACAGTTA
AATGCCGCCAAGCATCTCA -> ATGCCGCCAAGCATCTCAT
ACAGACGGACTGCCCTGCT -> CAGACGGACTGCCCTGCTT
CTTGTGAGCGTGACGTCCT -> TTGTGAGCGTGACGTCCTG
CTTGGACCACTTGGCCAGG -> TTGGACCACTTGGCCAGGG
GATCGCACCAGGTGGCTTT -> ATCGCACCAGGTGGCTTTA
TTAATCCAATTGTATTCTG -> TAATCCAATTGTATTCTGC
CTTTACCTCGACATCTGGC -> TTTACCTCGACATCTGGCG
GACCACAGATCCATGAATG -> ACCACAGATCCATGAATGA
CGGACCACCTAGAACCACC -> GGACCACCTAGAACCACCC
AACTTAAATTCGCCCAAAG -> ACTTAAATTCGCCCAAAGA
TACGGGAGGATTCCGCTAG -> ACGGGAGGATTCCGCTAGC
TCTCTTATTTGCCCATGGT -> CTCTTATTTGCCCATGGTA
CGCTACACCGACGTGAGGG -> GCTACACCGACGTGAGGGT
GCGGCGATTCGTGTCTGGC -> CGGCGATTCGTGTCTGGCT
GTGTCCTCTGACTACATAG -> TGTCCTCTGACTACATAGG
CGACAATCAAAGCCCGACC -> GACAATCAAAGCCCGACCT
GGTGTTACACACCGACCTG -> GTGTTACACACCGACCTGG
GGACCACCTAGAACCACCC -> GACCACCTAGAACCACCCA
ACAATGTACGGGCCAGCAG -> CAATGTACGGGCCAGCAGA
GTGTAGACTTTTTGCAGTT -> TGTAGACTTTTTGCAGTTA
GGGACAGTTAGCCGCGTAA -> GGACAGTTAGCCGCGTAAC
GGACTGACGCCGCTCAGGC -> GACTGACGCCGCTCAGGCC
CGGGCCTGATGGTGCACAC -> GGGCCTGATGGTGCACACC
CTGCAGTGTCCTCTGACTA -> TGCAGTGTCCTCTGACTAC
TGTGGCAAGGATCACAATC -> GTGGCAAGGATCACAATCA
GATACTCAGAGACGTCGTT -> ATACTCAGAGACGTCGTTG
GAATGAAGACGCCCGCCCC -> AATGAAGACGCCCGCCCCG
GCGGCACCGACCTTTATAG -> CGGCACCGACCTTTATAGC
TCGCAAGAAAGACTCGTCC -> CGCAAGAAAGACTCGTCCA
TGCGTACTCTGTCTCTTAT -> GCGTACTCTGTCTCTTATT
GATCTTGCATTACCCCTCC -> ATCTTGCATTACCCCTCCT
CCGTGTAATGCATCAATTA -> CGTGTAATGCATCAATTAG
GCTCCACGTCCTCTTGTGG -> CTCCACGTCCTCTTGTGGA
GCCGCTCAGGCCATAGGTA -> CCGCTCAGGCCATAGGTAA
TGGTGTCTGATACTCAGAG -> GGTGTCTGATACTCAGAGC
TTGGACACGGCCAGTCCTG -> TGGACACGGCCAGTCCTGG
CGAAATCACGTAGCCTTGA -> GAAATCACGTAGCCTTGAT
TGCCCCACATTGCCCTTGT -> GCCCCACATTGCCCTTGTA
GACTGCCCTGCTTGGGTGT -> ACTGCCCTGCTTGGGTGTA
CCTAGAACCACCCATTGCC -> CTAGAACCACCCATTGCCC
CGGCGGTAGACCTAAATGG -> GGCGGTAGACCTAAATGGA
AATACCGAAAGGAGTTTAT -> ATACCGAAAGGAGTTTATC
ACAGTCGTGGCCGTACATA -> CAGTCGTGGCCGTACATAT
TCCGTAGGCGCTTGTCTTG -> CCGTAGGCGCTTGTCTTGT
CGGCGTTGAATGGTTTTAA -> GGCGTTGAATGGTTTTAAG
TGGCCAGGGACAGTTAGCC -> GGCCAGGGACAGTTAGCCG
TATAGATTCATGGTCCTTC -> ATAGATTCATGGTCCTTCT
ACGTATGGCTCTGCGTATA -> CGTATGGCTCTGCGTATAG
TCTGTGCACAAATTTACAC -> CTGTGCACAAATTTACACC
ACGTGAGGGTATCGGCTCC -> CGTGAGGGTATCGGCTCCA
ATATACGAAACAAGACTAG -> TATACGAAACAAGACTAGT
AGGGAGAACAAAGGGACGC -> GGGAGAACAAAGGGACGCG
GGCACAGGAACTAAGGTTA -> GCACAGGAACTAAGGTTAT
AGGGTAGATCCTGGACAGC -> GGGTAGATCCTGGACAGCA
GCACCGACCTTTATAGCAT -> CACCGACCTTTATAGCATA
CGACACCGCGGGCCTGATG -> GACACCGCGGGCCTGATGG
AAGAAAGACTCGTCCAACC -> AGAAAGACTCGTCCAACCG
GGTGCCAGCAGGTGTTACA -> GTGCCAGCAGGTGTTACAC
GGACAGTTAGCCGCGTAAC -> GACAGTTAGCCGCGTAACA
CCAAAGATGGTCATTCCTG -> CAAAGATGGTCATTCCTGG
ATCCTGGCATCTTCCGACG -> TCCTGGCATCTTCCGACGA
AAATAGCCCTGACCCTTAT -> AATAGCCCTGACCCTTATC
AAGACCCCCGGCACCGTAC -> AGACCCCCGGCACCGTACG
CGTTGTCACCGTAGGAAGC -> GTTGTCACCGTAGGAAGCC
CTCCATGACCCGTAGGCGC -> TCCATGACCCGTAGGCGCT
CTTTATAGCATAATTAGGC -> TTTATAGCATAATTAGGCG
ATACCTCGGCGGTCCAAAT -> TACCTCGGCGGTCCAAATA
GGAGCAACTTAAATTCGCC -> GAGCAACTTAAATTCGCCC
AGGTAATCCGGTGATAGGA -> GGTAATCCGGTGATAGGAT
TTCCTGGCACAGGAACTAA -> TCCTGGCACAGGAACTAAG
AGATCCCTGCAACATATGT -> GATCCCTGCAACATATGTG
ACCTGGGACTGACGCCGCT -> CCTGGGACTGACGCCGCTC
ATCTTTTGCAACTGCACTT -> TCTTTTGCAACTGCACTTT
CCTATTCGGTCTAAAGAAC -> CTATTCGGTCTAAAGAACC
CCCAAAGATGGTCATTCCT -> CCAAAGATGGTCATTCCTG
GTTTTAAGCCGAGGTCGCT -> TTTTAAGCCGAGGTCGCTC
CTAGTCTTCAGGCTGGGTC -> TAGTCTTCAGGCTGGGTCG
GCTCCAGGACTAAGGGCTG -> CTCCAGGACTAAGGGCTGG
TCCTGTGGGCAGTTCCTGG -> CCTGTGGGCAGTTCCTGGC
ATAGAACGGCGTTGAATGG -> TAGAACGGCGTTGAATGGT
TCGCCCAAAGATGGTCATT -> CGCCCAAAGATGGTCATTC
CTCAGCGCGTCCGTCGACT -> TCAGCGCGTCCGTCGACTA
TTGATCATGGTGCTAGGAA -> TGATCATGGTGCTAGGAAA
GCCTTGATCATGGTGCTAG -> CCTTGATCATGGTGCTAGG
AGAAACTTGGTTAGTGACC -> GAAACTTGGTTAGTGACCT
GGGTAAGTTCGATGCAATG -> GGTAAGTTCGATGCAATGC
TTCTATATCCGTAGGCGCT -> TCTATATCCGTAGGCGCTT
TTCAACTTGGACCACTTGG -> TCAACTTGGACCACTTGGC
GGTGTCTGATACTCAGAGC -> GTGTCTGATACTCAGAGCT
GTCTAGTGGCTGCACGCTA -> TCTAGTGGCTGCACGCTAC
GAACCGACCCTGATGTTGG -> AACCGACCCTGATGTTGGA
ATTCAACAATGTACGGGCC -> TTCAACAATGTACGGGCCA
GCGGTAGACCTAAATGGAA -> CGGTAGACCTAAATGGAAC
CACTAGGACAGCTCGACGC -> ACTAGGACAGCTCGACGCG
CGTCACGTAGTCACGAGGT -> GTCACGTAGTCACGAGGTC
GAGGGTATCGGCTCCACGT -> AGGGTATCGGCTCCACGTC
GCAGTTCCTGGCGAAATAT -> CAGTTCCTGGCGAAATATA
CTGGCCCTCGCAAGAAAGA -> TGGCCCTCGCAAGAAAGAC
CCCTGATGTTGGATCCTTG -> CCTGATGTTGGATCCTTGC
TCCTGTACTCAGGCCGTGT -> CCTGTACTCAGGCCGTGTA
CATGGTAGGTGTCCAATTC -> ATGGTAGGTGTCCAATTCA
GACGTCGTTGGTTAGCACC -> ACGTCGTTGGTTAGCACCT
ACGAATATAGATTCATGGT -> CGAATATAGATTCATGGTC
TGCGACTTGCCCTGCGGCA -> GCGACTTGCCCTGCGGCAC
CATCCAAGCGCGCGCCCAT -> ATCCAAGCGCGCGCCCATT
GTTAGCCGCGTAACATTAG -> TTAGCCGCGTAACATTAGT
CTTGCATTACCCCTCCTAT -> TTGCATTACCCCTCCTATT
CGTAGCCTTGATCATGGTG -> GTAGCCTTGATCATGGTGC
CAGCTCGACGCGATCTTTT -> AGCTCGACGCGATCTTTTG
AGACGTCGTTGGTTAGCAC -> GACGTCGTTGGTTAGCACC
TAATCCTTACACGAATATA -> AATCCTTACACGAATATAG
ATATCCTATCCTCAGCGCG -> TATCCTATCCTCAGCGCGT
CAACCGCACGCCGACGAAT -> AACCGCACGCCGACGAATA
TGAATGGTTTTAAGCCGAG -> GAATGGTTTTAAGCCGAGG
CTTAAATTCGCCCAAAGAT -> TTAAATTCGCCCAAAGATG
TTAGAGGTGCATATCTTTA -> TAGAGGTGCATATCTTTAA
ATGGAACTGTCATTCACCA -> TGGAACTGTCATTCACCAG
TATGTGCATAGCATGTCCA -> ATGTGCATAGCATGTCCAG
ACTTCCCGACACCGCGGGC -> CTTCCCGACACCGCGGGCC
ACTGCGTGCGTACTCTGTC -> CTGCGTGCGTACTCTGTCT
GTTTGATGGTTTAGGTGCA -> TTTGATGGTTTAGGTGCAA
AGCTCGACGCGATCTTTTG -> GCTCGACGCGATCTTTTGC
TCGTTGGTTAGCACCTCCA -> CGTTGGTTAGCACCTCCAT
CGTCCAGATCCCTGCAACA -> GTCCAGATCCCTGCAACAT
GGTGCTAGGAAATAGCCCT -> GTGCTAGGAAATAGCCCTG
AAGGTTATACCTCGGCGGT -> AGGTTATACCTCGGCGGTC
CGTAGGCGCTTGTCTTGTG -> GTAGGCGCTTGTCTTGTGA
ACTCAGAGACGTCGTTGGT -> CTCAGAGACGTCGTTGGTT
GATGGTCATTCCTGGCCCT -> ATGGTCATTCCTGGCCCTC
TTGTCTTGGACACGGCCAG -> TGTCTTGGACACGGCCAGT
TAGTCTTAAGTCGTCCAGA -> AGTCTTAAGTCGTCCAGAT
GGCTGCACGCTACACCGAC -> GCTGCACGCTACACCGACG
ACCTATTCGGTCTAAAGAA -> CCTATTCGGTCTAAAGAAC
CGATCTTTTGCAACTGCAC -> GATCTTTTGCAACTGCACT
GTCCTCTGACTACATAGGG -> TCCTCTGACTACATAGGGT
GGACACGGCCAGTCCTGGC -> GACACGGCCAGTCCTGGCA
CCACCCATTGCCCCTCGAT -> CACCCATTGCCCCTCGATG
GCTGCGACTTGCCCTGCGG -> CTGCGACTTGCCCTGCGGC
GCACTTTACCTCGACATCT -> CACTTTACCTCGACATCTG
CGACCTTAATCCTTACACG -> GACCTTAATCCTTACACGA
TACTCTGTCTCTTATTTGC -> ACTCTGTCTCTTATTTGCC
CGGCCGTTAATCCTGGCAC -> GGCCGTTAATCCTGGCACA
TGGACCACTTGGCCAGGGA -> GGACCACTTGGCCAGGGAC
CTGGGGGAGCAACTTAAAT -> TGGGGGAGCAACTTAAATT
CCGCGTAACATTAGTAATG -> CGCGTAACATTAGTAATGG
CGCCCCGGTGCCAGCAGGT -> GCCCCGGTGCCAGCAGGTG
GTGTCGGCTGCGACTTGCC -> TGTCGGCTGCGACTTGCCC
ACCTCGGCGGTCCAAATAC -> CCTCGGCGGTCCAAATACC
CCTATCCTCAGCGCGTCCG -> CTATCCTCAGCGCGTCCGT
GTCCAGATCCCTGCAACAT -> TCCAGATCCCTGCAACATA
ATGGTGCTAGGAAATAGCC -> TGGTGCTAGGAAATAGCCC
CCTTATCTTGCCGCGCCGT -> CTTATCTTGCCGCGCCGTG
TGGACAAGCCTCTCGGAGT -> GGACAAGCCTCTCGGAGTA
ACGCCGCTCAGGCCATAGG -> CGCCGCTCAGGCCATAGGT
CCGTAGGCGCTTGTCTTGA -> CGTAGGCGCTTGTCTTGAG
GGCCAGCAGATAACCGCAC -> GCCAGCAGATAACCGCACT
CAAGCAAGATCGCACCAGG -> AAGCAAGATCGCACCAGGT
GGGCCAGCAGATAACCGCA -> GGCCAGCAGATAACCGCAC
TTGAGCCGCCGTAGGCGCT -> TGAGCCGCCGTAGGCGCTT
CGGTGCCAGCAGGTGTTAC -> GGTGCCAGCAGGTGTTACA
ACCAGCGAAATCACGTAGC -> CCAGCGAAATCACGTAGCC
ACACGGCCAGTCCTGGCAC -> CACGGCCAGTCCTGGCACA
GCCAACGACAATCAAAGCC -> CCAACGACAATCAAAGCCC
GATGGTGCACACCAAGACC -> ATGGTGCACACCAAGACCC
TCTGGCGCGGGTAAGTTCG -> CTGGCGCGGGTAAGTTCGA
GCACTAGGACAGCTCGACG -> CACTAGGACAGCTCGACGC
GCAAGCAAGATCGCACCAG -> CAAGCAAGATCGCACCAGG
ATTCATGGTCCTTCTATAT -> TTCATGGTCCTTCTATATC
TGTGGAGAGCGGCGATTCG -> GTGGAGAGCGGCGATTCGT
CTTGTCTTGCCGGCCGTTA -> TTGTCTTGCCGGCCGTTAA
CTCGATGCAAGTACTGTGG -> TCGATGCAAGTACTGTGGC
AGGAGTTTATCCTGTGGGC -> GGAGTTTATCCTGTGGGCA
GCGATTCGTGTCTGGCTTA -> CGATTCGTGTCTGGCTTAA
AGGCGCTTGTCTTGGACAC -> GGCGCTTGTCTTGGACACG
CGTTGGTTAGCACCTCCAT -> GTTGGTTAGCACCTCCATG
ATCCGTAGGCGCTTGTCTT -> TCCGTAGGCGCTTGTCTTG
CCTATTAGTCTTAAGTCGT -> CTATTAGTCTTAAGTCGTC
GTCGCTCCAGGACTAAGGG -> TCGCTCCAGGACTAAGGGC
CGTGAGGGTATCGGCTCCA -> GTGAGGGTATCGGCTCCAC
GTAGTCACGAGGTCGATAG -> TAGTCACGAGGTCGATAGC
AGCCGCCGTAGGCGCTTGT -> GCCGCCGTAGGCGCTTGTC
GACTTCCCGACACCGCGGG -> ACTTCCCGACACCGCGGGC
GCGCCCATTACCGCTTTAC -> CGCCCATTACCGCTTTACG
TTTACGGGAGGATTCCGCT -> TTACGGGAGGATTCCGCTA
CCCACATTGCCCTTGTAAT -> CCACATTGCCCTTGTAATG
TGGACCACAGATCCATGAA -> GGACCACAGATCCATGAAT
GGGTCGGGTTCCGGCGGTA -> GGTCGGGTTCCGGCGGTAG
TAGTAATGGAAGTATCTGT -> AGTAATGGAAGTATCTGTG
ATAATTAGGCGCTCATACC -> TAATTAGGCGCTCATACCG
CAATTCAACAGACGGACTG -> AATTCAACAGACGGACTGC
CATGGTGCTAGGAAATAGC -> ATGGTGCTAGGAAATAGCC
GACTTGCCCTGCGGCACCG -> ACTTGCCCTGCGGCACCGA
GAGCGGCGATTCGTGTCTG -> AGCGGCGATTCGTGTCTGG
CGTCGACTATACCGGTTAC -> GTCGACTATACCGGTTACG
GGACAGCACGTCACGTAGT -> GACAGCACGTCACGTAGTC
AGACGGACTGCCCTGCTTG -> GACGGACTGCCCTGCTTGG
CCTGCAACATATGTGCATA -> CTGCAACATATGTGCATAG
AGTCTTCAGGCTGGGTCGG -> GTCTTCAGGCTGGGTCGGG
GGTAGGTGTCCAATTCAAC -> GTAGGTGTCCAATTCAACA
GCGCTCATACCGTACATAA -> CGCTCATACCGTACATAAC
GTCTGGCCCGACCTTAATC -> TCTGGCCCGACCTTAATCC
CACATTTTTCCTGTACTCA -> ACATTTTTCCTGTACTCAG
TGCACTTTACCTCGACATC -> GCACTTTACCTCGACATCT
CATATCCTATCCTCAGCGC -> ATATCCTATCCTCAGCGCG
AGCCCTGACCCTTATCTTG -> GCCCTGACCCTTATCTTGC
ACAGCACGTCACGTAGTCA -> CAGCACGTCACGTAGTCAC
TGCCCTATCATGAGACCTT -> GCCCTATCATGAGACCTTG
AATCCTGGCACAGGAACTA -> ATCCTGGCACAGGAACTAA
GGAACTAAGGAACCCTTCT -> GAACTAAGGAACCCTTCTT
AGTGACCTTACCGCTGCGA -> GTGACCTTACCGCTGCGAT
CATTACCGCTTTACGGGAG -> ATTACCGCTTTACGGGAGG
TGTGCATAGCATGTCCAGT -> GTGCATAGCATGTCCAGTG
CATGAATGAAGACGCCCGC -> ATGAATGAAGACGCCCGCC
AATTGAGCGTCACTTAAAC -> ATTGAGCGTCACTTAAACA
CCATGAATGAAGACGCCCG -> CATGAATGAAGACGCCCGC
TTAGGTGCAACCGAGGTGT -> TAGGTGCAACCGAGGTGTA
TTACCTCGACATCTGGCGC -> TACCTCGACATCTGGCGCG
ACCGACCCTGATGTTGGAT -> CCGACCCTGATGTTGGATC
CATAGCATGTCCAGTGTAG -> ATAGCATGTCCAGTGTAGA
TTCGTCCACTTGCTCATCC -> TCGTCCACTTGCTCATCCA
ACCGTCTGGCCCGACCTTA -> CCGTCTGGCCCGACCTTAA
TTGTCTTGTGAGCGTGACG -> TGTCTTGTGAGCGTGACGT
GAGGTCGCTCCAGGACTAA -> AGGTCGCTCCAGGACTAAG
GCCAGCAGATAACCGCACT -> CCAGCAGATAACCGCACTA
CGCTTTACGGGAGGATTCC -> GCTTTACGGGAGGATTCCG
TGTCTGATACTCAGAGCTG -> GTCTGATACTCAGAGCTGG
AGTCGTGGCCGTACATATC -> GTCGTGGCCGTACATATCC
AGAACAAAGGGACGCGCCA -> GAACAAAGGGACGCGCCAG
TATCCTATCCTCAGCGCGT -> ATCCTATCCTCAGCGCGTC
TACGGGCCAGCAGATAACC -> ACGGGCCAGCAGATAACCG
ACCTCCATGACCCGTAGGC -> CCTCCATGACCCGTAGGCG
GTTAATCCAATTGTATTCT -> TTAATCCAATTGTATTCTG
GCAAGAAACTTGGTTAGTG -> CAAGAAACTTGGTTAGTGA
ACCTCGACATCTGGCGCGG -> CCTCGACATCTGGCGCGGG
GTGAGGGTATCGGCTCCAC -> TGAGGGTATCGGCTCCACG
AGGATTCCGCTAGCGTGTC -> GGATTCCGCTAGCGTGTCG
GTATAATTTATGTGGACAG -> TATAATTTATGTGGACAGT
TGCACGCTACACCGACGTG -> GCACGCTACACCGACGTGA
GCTCAGGCCATAGGTAATC -> CTCAGGCCATAGGTAATCC
GGAACTGTCATTCACCAGC -> GAACTGTCATTCACCAGCG
CTTACCGCTGCGATGGCAG -> TTACCGCTGCGATGGCAGA
GAAATATACGAAACAAGAC -> AAATATACGAAACAAGACT
CAGATCCATGAATGAAGAC -> AGATCCATGAATGAAGACG
TGGGTCGGGTTCCGGCGGT -> GGGTCGGGTTCCGGCGGTA
CGCCAAGCATCTCATTTTC -> GCCAAGCATCTCATTTTCG
GTGGAGAGCGGCGATTCGT -> TGGAGAGCGGCGATTCGTG
CGTACGGCATGTCGACGTA -> GTACGGCATGTCGACGTAT
ATCCGGTGATAGGATCCCC -> TCCGGTGATAGGATCCCCG
TCCAATGCCGCCAAGCATC -> CCAATGCCGCCAAGCATCT
CGTCCGTCGACTATACCGG -> GTCCGTCGACTATACCGGT
TACCGCTTTACGGGAGGAT -> ACCGCTTTACGGGAGGATT
TGGCATCTTCCGACGATCT -> GGCATCTTCCGACGATCTT
ACCACTTGGCCAGGGACAG -> CCACTTGGCCAGGGACAGT
AATTTGGACCACAGATCCA -> ATTTGGACCACAGATCCAT
ATTTGGACCACAGATCCAT -> TTTGGACCACAGATCCATG
GCAAGAAAGACTCGTCCAA -> CAAGAAAGACTCGTCCAAC
ATCTCTCGAAACGGTTCAA -> TCTCTCGAAACGGTTCAAC
GACGCCCGCCCCGGTGCCA -> ACGCCCGCCCCGGTGCCAG
TTTTGCAACTGCACTTTAC -> TTTGCAACTGCACTTTACC
GCGCGCCCATTACCGCTTT -> CGCGCCCATTACCGCTTTA
TTTGGCCAACGACAATCAA -> TTGGCCAACGACAATCAAA
ATGTCCAGTGTAGACTTTT -> TGTCCAGTGTAGACTTTTT
AATTCAACAGACGGACTGC -> ATTCAACAGACGGACTGCC
CCAAGCGCGCGCCCATTAC -> CAAGCGCGCGCCCATTACC
CAATCAAAGCCCGACCTAC -> AATCAAAGCCCGACCTACA
CGTCCTGGCACAGGAACTA -> GTCCTGGCACAGGAACTAA
CTGGGACTGACGCCGCTCA -> TGGGACTGACGCCGCTCAG
AGCGTGTCGGCTGCGACTT -> GCGTGTCGGCTGCGACTTG
TATAGCATAATTAGGCGCT -> ATAGCATAATTAGGCGCTC
GTTTAGGTGCAACCGAGGT -> TTTAGGTGCAACCGAGGTG
TGTATAATTTATGTGGACA -> GTATAATTTATGTGGACAG
TACACCGACGTGAGGGTAT -> ACACCGACGTGAGGGTATC
AGGTCACCTATTCGGTCTA -> GGTCACCTATTCGGTCTAA
AGAAAGACTCGTCCAACCG -> GAAAGACTCGTCCAACCGC
ATAGATTCATGGTCCTTCT -> TAGATTCATGGTCCTTCTA
ATGCCGCCAAGCATCTCAT -> TGCCGCCAAGCATCTCATT
CTCGAAACGGTTCAACTTG -> TCGAAACGGTTCAACTTGG
GGCCAACGACAATCAAAGC -> GCCAACGACAATCAAAGCC
TCTAGTGGCTGCACGCTAC -> CTAGTGGCTGCACGCTACA
ACATTGCCCTTGTAATGCC -> CATTGCCCTTGTAATGCCC
ATGTGGACAGTCGTGGCCG -> TGTGGACAGTCGTGGCCGT
AGCCCGACCTACACACCGT -> GCCCGACCTACACACCGTT
GGCTTCCTGGCACAGGAAC -> GCTTCCTGGCACAGGAACT
AACGTTGTCACCGTAGGAA -> ACGTTGTCACCGTAGGAAG
CTTGATTCGTACGGCATGT -> TTGATTCGTACGGCATGTC
AAATTTACACCCTCTAAGC -> AATTTACACCCTCTAAGCG
GGCGCTTGTCTTGGACACG -> GCGCTTGTCTTGGACACGG
GTTATACCTCGGCGGTCCA -> TTATACCTCGGCGGTCCAA
GCGTGCGTACTCTGTCTCT -> CGTGCGTACTCTGTCTCTT
GCCTGATGGTGCACACCAA -> CCTGATGGTGCACACCAAG
TAAAGAACCGACCCTGATG -> AAAGAACCGACCCTGATGT
CCACCTAGAACCACCCATT -> CACCTAGAACCACCCATTG
TTTTTGCAGTTAATCCAAT -> TTTTGCAGTTAATCCAATT
ACCGTACGCAATTGAGCGT -> CCGTACGCAATTGAGCGTC
GGCCCGACCTTAATCCTTA -> GCCCGACCTTAATCCTTAC
CTATACCGGTTACGCGGGT -> TATACCGGTTACGCGGGTC
CCCCAAATTATCCTGGCAT -> CCCAAATTATCCTGGCATC
GTCTTGCCGGCCGTTAATC -> TCTTGCCGGCCGTTAATCC
TTGCCCTGCGGCACCGACC -> TGCCCTGCGGCACCGACCT
CGGCATGTCGACGTATAGG -> GGCATGTCGACGTATAGGT
ATTTTCGTCCACTTGCTCA -> TTTTCGTCCACTTGCTCAT
CGACATCTGGCGCGGGTAA -> GACATCTGGCGCGGGTAAG
AAACAAGACTAGTCTTCAG -> AACAAGACTAGTCTTCAGG
TAGATCCTGGACAGCACGT -> AGATCCTGGACAGCACGTC
AACCGAGGTGTATTCAACA -> ACCGAGGTGTATTCAACAA
AATTAGGCGCTCATACCGT -> ATTAGGCGCTCATACCGTA
TTAATCTTAGAGCGCCGAC -> TAATCTTAGAGCGCCGACA
AAGAACCGACCCTGATGTT -> AGAACCGACCCTGATGTTG
GTGGCTGCACGCTACACCG -> TGGCTGCACGCTACACCGA
CTTAATCCTTACACGAATA -> TTAATCCTTACACGAATAT
CCCGACACCGCGGGCCTGA -> CCGACACCGCGGGCCTGAT
CATAACATAGGTCACCTAT -> ATAACATAGGTCACCTATT
CAGGAACTAAGGTTATACC -> AGGAACTAAGGTTATACCT
AGGATCACAATCACCGTCT -> GGATCACAATCACCGTCTG
GTCTAAAGAACCGACCCTG -> TCTAAAGAACCGACCCTGA
TGAGCGTGACGTCCTGGCA -> GAGCGTGACGTCCTGGCAC
CCGTTAATCCTGGCACAGG -> CGTTAATCCTGGCACAGGA
GTATTCTGCCCCACATTGC -> TATTCTGCCCCACATTGCC
AACTAAGCGGGGCTTCCTG -> ACTAAGCGGGGCTTCCTGG
CGGTAGACCTAAATGGAAC -> GGTAGACCTAAATGGAACT
GTGACCTTACCGCTGCGAT -> TGACCTTACCGCTGCGATG
CCGTACATATCCTATCCTC -> CGTACATATCCTATCCTCA
ATAGCCCTGACCCTTATCT -> TAGCCCTGACCCTTATCTT
TAGGTGCAACCGAGGTGTA -> AGGTGCAACCGAGGTGTAT
CCGGTGATAGGATCCCCGA -> CGGTGATAGGATCCCCGAA
TTCAACAATGTACGGGCCA -> TCAACAATGTACGGGCCAG
ATCTTCCGACGATCTTGCA -> TCTTCCGACGATCTTGCAT
ACTTGGACCACTTGGCCAG -> CTTGGACCACTTGGCCAGG
CTATCCTCAGCGCGTCCGT -> TATCCTCAGCGCGTCCGTC
TACGCAATTGAGCGTCACT -> ACGCAATTGAGCGTCACTT
GTCGATAGCAAGAAACTTG -> TCGATAGCAAGAAACTTGG
TAGCCTTGATCATGGTGCT -> AGCCTTGATCATGGTGCTA
ATGTCGACGTATAGGTTTG -> TGTCGACGTATAGGTTTGA
CGATTTAATTGTATGCCCT -> GATTTAATTGTATGCCCTA
ATAGGATCCCCGAAACGTA -> TAGGATCCCCGAAACGTAT
CGGGAGGATTCCGCTAGCG -> GGGAGGATTCCGCTAGCGT
ATTCCTGGCCCTCGCAAGA -> TTCCTGGCCCTCGCAAGAA
GTAGGCGCTTGTCTTGAGC -> TAGGCGCTTGTCTTGAGCC
CCACAGATCCATGAATGAA -> CACAGATCCATGAATGAAG
TGGCCCTCGCAAGAAAGAC -> GGCCCTCGCAAGAAAGACT
ACCGAGGTGTATTCAACAA -> CCGAGGTGTATTCAACAAT
CACGTCACGTAGTCACGAG -> ACGTCACGTAGTCACGAGG
CAGCAGGTGTTACACACCG -> AGCAGGTGTTACACACCGA
TGCCCATGGTAGGTGTCCA -> GCCCATGGTAGGTGTCCAA
CAGCGAAATCACGTAGCCT -> AGCGAAATCACGTAGCCTT
TGGCTTTAGAGCTAAGTAG -> GGCTTTAGAGCTAAGTAGA
CAACTGCACTTTACCTCGA -> AACTGCACTTTACCTCGAC
ACATTTTTCCTGTACTCAG -> CATTTTTCCTGTACTCAGG
TGGTAGGTGTCCAATTCAA -> GGTAGGTGTCCAATTCAAC
TACCTCGGCGGTCCAAATA -> ACCTCGGCGGTCCAAATAC
TCTGATACTCAGAGCTGGG -> CTGATACTCAGAGCTGGGG
TTCACCAGCGAAATCACGT -> TCACCAGCGAAATCACGTA
GACTGTGTAGGCTATCTCT -> ACTGTGTAGGCTATCTCTC
GAGGATTCCGCTAGCGTGT -> AGGATTCCGCTAGCGTGTC
GTACGGGCCAGCAGATAAC -> TACGGGCCAGCAGATAACC
TCAGGCCATAGGTAATCCG -> CAGGCCATAGGTAATCCGG
GGACTAAGGGCTGGCGATT -> GACTAAGGGCTGGCGATTT
ATCCTATCCTCAGCGCGTC -> TCCTATCCTCAGCGCGTCC
ACGGGCCAGCAGATAACCG -> CGGGCCAGCAGATAACCGC
ACTTAAATTCGCCCAAAGA -> CTTAAATTCGCCCAAAGAT
AGGTGCATATCTTTAAACT -> GGTGCATATCTTTAAACTG
AGGAACTAAGGTTATACCT -> GGAACTAAGGTTATACCTC
CAAGTTCGGGACTGTGTAG -> AAGTTCGGGACTGTGTAGG
GTCCAATTCAACAGACGGA -> TCCAATTCAACAGACGGAC
TTCAACAGACGGACTGCCC -> TCAACAGACGGACTGCCCT
GTGGCCGTACATATCCTAT -> TGGCCGTACATATCCTATC
ACGTCACGTAGTCACGAGG -> CGTCACGTAGTCACGAGGT
GGCAACCGTAGGCGCTTGT -> GCAACCGTAGGCGCTTGTC
GAACTGTCATTCACCAGCG -> AACTGTCATTCACCAGCGA
ACGAATACCGAAAGGAGTT -> CGAATACCGAAAGGAGTTT
ATGGTTTAGGTGCAACCGA -> TGGTTTAGGTGCAACCGAG
GTGCAACCGAGGTGTATTC -> TGCAACCGAGGTGTATTCA
TGACCCGTAGGCGCTTGTC -> GACCCGTAGGCGCTTGTCT
GGGAGGATTCCGCTAGCGT -> GGAGGATTCCGCTAGCGTG
GGTTATACCTCGGCGGTCC -> GTTATACCTCGGCGGTCCA
GCAGATAACCGCACTAGGA -> CAGATAACCGCACTAGGAC
CTGCCCTGCTTGGGTGTAT -> TGCCCTGCTTGGGTGTATA
ACGGGAGGATTCCGCTAGC -> CGGGAGGATTCCGCTAGCG
TGGCGAAATATACGAAACA -> GGCGAAATATACGAAACAA
CGACTTGCCCTGCGGCACC -> GACTTGCCCTGCGGCACCG
CGTTGGTGTCTGATACTCA -> GTTGGTGTCTGATACTCAG
CCGGTGCCAGCAGGTGTTA -> CGGTGCCAGCAGGTGTTAC
TACACCCTCTAAGCGTATT -> ACACCCTCTAAGCGTATTT
CCTGATGTTGGATCCTTGC -> CTGATGTTGGATCCTTGCG
GTGAGCGTGACGTCCTGGC -> TGAGCGTGACGTCCTGGCA
GTCATTCACCAGCGAAATC -> TCATTCACCAGCGAAATCA
CTCCTATTAGTCTTAAGTC -> TCCTATTAGTCTTAAGTCG
CACACCAAGACCCCCGGCA -> ACACCAAGACCCCCGGCAC
AGGCGCTTGTCTTGAGCCG -> GGCGCTTGTCTTGAGCCGC
GCGGGGCTTCCTGGCACAG -> CGGGGCTTCCTGGCACAGG
TCGATAGCAAGAAACTTGG -> CGATAGCAAGAAACTTGGT
CATAGGTAATCCGGTGATA -> ATAGGTAATCCGGTGATAG
TTGGCAAGCAAGATCGCAC -> TGGCAAGCAAGATCGCACC
CGCACGCCGACGAATACCG -> GCACGCCGACGAATACCGA
CTTGTAATGCCCTCCGAAT -> TTGTAATGCCCTCCGAATT
TACGAAACAAGACTAGTCT -> ACGAAACAAGACTAGTCTT
ATTGTATTCTGCCCCACAT -> TTGTATTCTGCCCCACATT
TAAGTTCGATGCAATGCCT -> AAGTTCGATGCAATGCCTT
AGTCTTAAGTCGTCCAGAT -> GTCTTAAGTCGTCCAGATC
CCTGGCACAGGAACTAAGG -> CTGGCACAGGAACTAAGGG, CTGGCACAGGAACTAAGGT, CTGGCACAGGAACTAAGGA
TGTCACCGTAGGAAGCCAA -> GTCACCGTAGGAAGCCAAG
TAGGCGCTTGTCTTGGACA -> AGGCGCTTGTCTTGGACAC
CAGGCCATAGGTAATCCGG -> AGGCCATAGGTAATCCGGT
CCTCGGCGGTCCAAATACC -> CTCGGCGGTCCAAATACCC
CACCAGCGAAATCACGTAG -> ACCAGCGAAATCACGTAGC
CCTTGATCATGGTGCTAGG -> CTTGATCATGGTGCTAGGA
CTGGCGAAATATACGAAAC -> TGGCGAAATATACGAAACA
CGACGTGAGGGTATCGGCT -> GACGTGAGGGTATCGGCTC
GTTACGCGGGTCTGCAGTG -> TTACGCGGGTCTGCAGTGT
AATCACCGTCTGGCCCGAC -> ATCACCGTCTGGCCCGACC
TCACCGTCTGGCCCGACCT -> CACCGTCTGGCCCGACCTT
ACAAATTTACACCCTCTAA -> CAAATTTACACCCTCTAAG
AGAACCGACCCTGATGTTG -> GAACCGACCCTGATGTTGG
GGTGATAGGATCCCCGAAA -> GTGATAGGATCCCCGAAAC
TCGGCTGCGACTTGCCCTG -> CGGCTGCGACTTGCCCTGC
GAACCCTTCTTAACGTTGT -> AACCCTTCTTAACGTTGTC
TGTATTCTGCCCCACATTG -> GTATTCTGCCCCACATTGC
GACTATACCGGTTACGCGG -> ACTATACCGGTTACGCGGG
GGTGCAACCGAGGTGTATT -> GTGCAACCGAGGTGTATTC
AGACTCGTCCAACCGCACG -> GACTCGTCCAACCGCACGC
ATATCTTTAAACTGGACAA -> TATCTTTAAACTGGACAAG
CGTGTCTGGCTTAATCTTA -> GTGTCTGGCTTAATCTTAG
CTGCACTTTACCTCGACAT -> TGCACTTTACCTCGACATC
CCGGCCGTTAATCCTGGCA -> CGGCCGTTAATCCTGGCAC
AAAGCCCGACCTACACACC -> AAGCCCGACCTACACACCG
TCCTTACACGAATATAGAT -> CCTTACACGAATATAGATT
ATGGAAGTATCTGTGCACA -> TGGAAGTATCTGTGCACAA
ACCTTAATCCTTACACGAA -> CCTTAATCCTTACACGAAT
TCATGGTGCTAGGAAATAG -> CATGGTGCTAGGAAATAGC
GACAGTTAGCCGCGTAACA -> ACAGTTAGCCGCGTAACAT
GTCTGATACTCAGAGCTGG -> TCTGATACTCAGAGCTGGG
CACACCGTTGGTGTCTGAT -> ACACCGTTGGTGTCTGATA
GGACCACAGATCCATGAAT -> GACCACAGATCCATGAATG
TATACCTCGGCGGTCCAAA -> ATACCTCGGCGGTCCAAAT
ACTATACCGGTTACGCGGG -> CTATACCGGTTACGCGGGT
GTGTAGGCTATCTCTCGAA -> TGTAGGCTATCTCTCGAAA
CACCGACCTTTATAGCATA -> ACCGACCTTTATAGCATAA
TAGAGCTAAGTAGATACTC -> AGAGCTAAGTAGATACTCA
TACACACCGTTGGTGTCTG -> ACACACCGTTGGTGTCTGA
CTCGACGCGATCTTTTGCA -> TCGACGCGATCTTTTGCAA
CTTTTGCAACTGCACTTTA -> TTTTGCAACTGCACTTTAC
CATACCGTACATAACATAG -> ATACCGTACATAACATAGG
GAAACTTGGTTAGTGACCT -> AAACTTGGTTAGTGACCTT
CTGTCTCTTATTTGCCCAT -> TGTCTCTTATTTGCCCATG
AGCGCCGACAGGCAACCGT -> GCGCCGACAGGCAACCGTA
AACCGCACGCCGACGAATA -> ACCGCACGCCGACGAATAC
AATCACGTAGCCTTGATCA -> ATCACGTAGCCTTGATCAT
GACGATCTTGCATTACCCC -> ACGATCTTGCATTACCCCT
TCAAAGCCCGACCTACACA -> CAAAGCCCGACCTACACAC
TGCAACTGCACTTTACCTC -> GCAACTGCACTTTACCTCG
ACACCGACCTGGGACTGAC -> CACCGACCTGGGACTGACG
GTTAGTGACCTTACCGCTG -> TTAGTGACCTTACCGCTGC
TGCCGGCCGTTAATCCTGG -> GCCGGCCGTTAATCCTGGC
CAAGCCTCTCGGAGTAGAT -> AAGCCTCTCGGAGTAGATC
TTGCCGCGCCGTGCGGTCA -> TGCCGCGCCGTGCGGTCAC
GTAAGTTCGATGCAATGCC -> TAAGTTCGATGCAATGCCT
GTCCACTTGCTCATCCAAG -> TCCACTTGCTCATCCAAGC
ACCCTTCTTAACGTTGTCA -> CCCTTCTTAACGTTGTCAC
TGTCTCTTATTTGCCCATG -> GTCTCTTATTTGCCCATGG
CCGTACGCAATTGAGCGTC -> CGTACGCAATTGAGCGTCA
GCCAAGTTCGGGACTGTGT -> CCAAGTTCGGGACTGTGTA
CCCGACCTACACACCGTTG -> CCGACCTACACACCGTTGG
AATCCAATTGTATTCTGCC -> ATCCAATTGTATTCTGCCC
GCCGTTAATCCTGGCACAG -> CCGTTAATCCTGGCACAGG
CTATCTCTCGAAACGGTTC -> TATCTCTCGAAACGGTTCA
TCCAATTCAACAGACGGAC -> CCAATTCAACAGACGGACT
CCTCATCCAATGCCGCCAA -> CTCATCCAATGCCGCCAAG
TCATGGTCCTTCTATATCC -> CATGGTCCTTCTATATCCG
TCCTGGCGAAATATACGAA -> CCTGGCGAAATATACGAAA
AAATTATCCTGGCATCTTC -> AATTATCCTGGCATCTTCC
ACATATCCTATCCTCAGCG -> CATATCCTATCCTCAGCGC
TTTGCCCATGGTAGGTGTC -> TTGCCCATGGTAGGTGTCC
TCTCGGAGTAGATCTTGGC -> CTCGGAGTAGATCTTGGCA
ATAACATAGGTCACCTATT -> TAACATAGGTCACCTATTC
TAGGGTAGATCCTGGACAG -> AGGGTAGATCCTGGACAGC
ATGCATCAATTAGAGGTGC -> TGCATCAATTAGAGGTGCA
TGGCCAACGACAATCAAAG -> GGCCAACGACAATCAAAGC
CAGCACGTCACGTAGTCAC -> AGCACGTCACGTAGTCACG
TCCTTGCGAACTGCGTGCG -> CCTTGCGAACTGCGTGCGT
CCGCCCCGGTGCCAGCAGG -> CGCCCCGGTGCCAGCAGGT
CTAGAACCACCCATTGCCC -> TAGAACCACCCATTGCCCC
AACAGACGGACTGCCCTGC -> ACAGACGGACTGCCCTGCT
TACATAGGGTAGATCCTGG -> ACATAGGGTAGATCCTGGA
AAGTACTGTGGCAAGGATC -> AGTACTGTGGCAAGGATCA
TTTCCTGTACTCAGGCCGT -> TTCCTGTACTCAGGCCGTG
TAGCAAGAAACTTGGTTAG -> AGCAAGAAACTTGGTTAGT
AGACCTAAATGGAACTGTC -> GACCTAAATGGAACTGTCA
TGGACAGCACGTCACGTAG -> GGACAGCACGTCACGTAGT
TTATCTTGCCGCGCCGTGC -> TATCTTGCCGCGCCGTGCG
ACAAAGGGACGCGCCAGTC -> CAAAGGGACGCGCCAGTCT
CGGCACCGTACGCAATTGA -> GGCACCGTACGCAATTGAG
TTAAACTGGACAAGCCTCT -> TAAACTGGACAAGCCTCTC
GCGCGGGTAAGTTCGATGC -> CGCGGGTAAGTTCGATGCA
CCAGCGAAATCACGTAGCC -> CAGCGAAATCACGTAGCCT
CATTCCTGGCCCTCGCAAG -> ATTCCTGGCCCTCGCAAGA
CTGACCCTTATCTTGCCGC -> TGACCCTTATCTTGCCGCG
GGGCTGGCGATTTAATTGT -> GGCTGGCGATTTAATTGTA
CATCTCATTTTCGTCCACT -> ATCTCATTTTCGTCCACTT
TGGCAAGGATCACAATCAC -> GGCAAGGATCACAATCACC
GCCCGCCCCGGTGCCAGCA -> CCCGCCCCGGTGCCAGCAG
GCATCTCATTTTCGTCCAC -> CATCTCATTTTCGTCCACT
TAGGAAGCCAAGTTCGGGA -> AGGAAGCCAAGTTCGGGAC
AGTTAGCCGCGTAACATTA -> GTTAGCCGCGTAACATTAG
TCGTCCAACCGCACGCCGA -> CGTCCAACCGCACGCCGAC
GCGTATTTGGCCAACGACA -> CGTATTTGGCCAACGACAA
CGATGGCGGACCACCTAGA -> GATGGCGGACCACCTAGAA
GGCATCTTCCGACGATCTT -> GCATCTTCCGACGATCTTG
AAGACGCCCGCCCCGGTGC -> AGACGCCCGCCCCGGTGCC
TCTGCCCCACATTGCCCTT -> CTGCCCCACATTGCCCTTG
ACTAAGGGAGAACAAAGGG -> CTAAGGGAGAACAAAGGGA
GACCTACACACCGTTGGTG -> ACCTACACACCGTTGGTGT
CCTATCATGAGACCTTGAT -> CTATCATGAGACCTTGATT
GTCGGGTTCCGGCGGTAGA -> TCGGGTTCCGGCGGTAGAC
CTTCCCGACACCGCGGGCC -> TTCCCGACACCGCGGGCCT
TTAGAGCGCCGACAGGCAA -> TAGAGCGCCGACAGGCAAC
ATGGTTTTAAGCCGAGGTC -> TGGTTTTAAGCCGAGGTCG
CAACCGAGGTGTATTCAAC -> AACCGAGGTGTATTCAACA
CCCTTCTTAACGTTGTCAC -> CCTTCTTAACGTTGTCACC
CTAGGAAATAGCCCTGACC -> TAGGAAATAGCCCTGACCC
TTGTATTCTGCCCCACATT -> TGTATTCTGCCCCACATTG
CGTAGGCGCTTGTCTTGGA -> GTAGGCGCTTGTCTTGGAC
GGCAAGGATCACAATCACC -> GCAAGGATCACAATCACCG
GTACATAACATAGGTCACC -> TACATAACATAGGTCACCT
TAATTGTATGCCCTATCAT -> AATTGTATGCCCTATCATG
GTAGATCTTGGCAAGCAAG -> TAGATCTTGGCAAGCAAGA
AGCATAATTAGGCGCTCAT -> GCATAATTAGGCGCTCATA
GTAATGGAAGTATCTGTGC -> TAATGGAAGTATCTGTGCA
CTGGGTCGGGTTCCGGCGG -> TGGGTCGGGTTCCGGCGGT
CTGTCATTCACCAGCGAAA -> TGTCATTCACCAGCGAAAT
CTTATTTGCCCATGGTAGG -> TTATTTGCCCATGGTAGGT
ACCTTACCGCTGCGATGGC -> CCTTACCGCTGCGATGGCA
TTACACCCTCTAAGCGTAT -> TACACCCTCTAAGCGTATT
AGCATCTCATTTTCGTCCA -> GCATCTCATTTTCGTCCAC
CCTCTCGGAGTAGATCTTG -> CTCTCGGAGTAGATCTTGG
TCTTGCATTACCCCTCCTA -> CTTGCATTACCCCTCCTAT
CCATTACCGCTTTACGGGA -> CATTACCGCTTTACGGGAG
CATGACCCGTAGGCGCTTG -> ATGACCCGTAGGCGCTTGT
GGCACAGGAACTAAGGAAC -> GCACAGGAACTAAGGAACC
TCGACGTATAGGTTTGATG -> CGACGTATAGGTTTGATGG
ATAATTTATGTGGACAGTC -> TAATTTATGTGGACAGTCG
AGGTTTGATGGTTTAGGTG -> GGTTTGATGGTTTAGGTGC
CACCGTACGCAATTGAGCG -> ACCGTACGCAATTGAGCGT
AGTTAATCCAATTGTATTC -> GTTAATCCAATTGTATTCT
GCTAGGAAATAGCCCTGAC -> CTAGGAAATAGCCCTGACC
TACACGAATATAGATTCAT -> ACACGAATATAGATTCATG
CGCCGCTCAGGCCATAGGT -> GCCGCTCAGGCCATAGGTA
TGTAGACTTTTTGCAGTTA -> GTAGACTTTTTGCAGTTAA
AAGATCGCACCAGGTGGCT -> AGATCGCACCAGGTGGCTT
GGCCAGGGACAGTTAGCCG -> GCCAGGGACAGTTAGCCGC
GAATTTGGACCACAGATCC -> AATTTGGACCACAGATCCA
CGATGCAAGTACTGTGGCA -> GATGCAAGTACTGTGGCAA
GGACAAGCCTCTCGGAGTA -> GACAAGCCTCTCGGAGTAG
TGCGTGCGTACTCTGTCTC -> GCGTGCGTACTCTGTCTCT
TAGGCTATCTCTCGAAACG -> AGGCTATCTCTCGAAACGG
CGCGGGCCTGATGGTGCAC -> GCGGGCCTGATGGTGCACA
AAGGGACGCGCCAGTCTAG -> AGGGACGCGCCAGTCTAGT
CTCATACCGTACATAACAT -> TCATACCGTACATAACATA
TTCTTAACGTTGTCACCGT -> TCTTAACGTTGTCACCGTA
CCGGTTACGCGGGTCTGCA -> CGGTTACGCGGGTCTGCAG
AACCACCCATTGCCCCTCG -> ACCACCCATTGCCCCTCGA
ACCGCGGGCCTGATGGTGC -> CCGCGGGCCTGATGGTGCA
TGCAACATATGTGCATAGC -> GCAACATATGTGCATAGCA
GCGTTGAATGGTTTTAAGC -> CGTTGAATGGTTTTAAGCC
GAACTAAGGGAGAACAAAG -> AACTAAGGGAGAACAAAGG
GCCAGTCTAGTGGCTGCAC -> CCAGTCTAGTGGCTGCACG
CTAAGGGCTGGCGATTTAA -> TAAGGGCTGGCGATTTAAT
GGCCGTTAATCCTGGCACA -> GCCGTTAATCCTGGCACAG
CTTAGAGCGCCGACAGGCA -> TTAGAGCGCCGACAGGCAA
TGCAATGCCTTCGATGGCG -> GCAATGCCTTCGATGGCGG
TAAGTCGTCCAGATCCCTG -> AAGTCGTCCAGATCCCTGC
ACTGTGGCAAGGATCACAA -> CTGTGGCAAGGATCACAAT
CGGCGGTCCAAATACCCTC -> GGCGGTCCAAATACCCTCA
CCGACGATCTTGCATTACC -> CGACGATCTTGCATTACCC
CCGCTTTACGGGAGGATTC -> CGCTTTACGGGAGGATTCC
CTCCGAATTTGGACCACAG -> TCCGAATTTGGACCACAGA
ATCCAATGCCGCCAAGCAT -> TCCAATGCCGCCAAGCATC
CACCCTCTAAGCGTATTTG -> ACCCTCTAAGCGTATTTGG
CTAAGGAACCCTTCTTAAC -> TAAGGAACCCTTCTTAACG
GAATATAGATTCATGGTCC -> AATATAGATTCATGGTCCT
TCACCGTAGGAAGCCAAGT -> CACCGTAGGAAGCCAAGTT
ATGAAGACGCCCGCCCCGG -> TGAAGACGCCCGCCCCGGT
TACGGCATGTCGACGTATA -> ACGGCATGTCGACGTATAG
GCTGGGGGAGCAACTTAAA -> CTGGGGGAGCAACTTAAAT
TAACATTAGTAATGGAAGT -> AACATTAGTAATGGAAGTA
GCCGCCGTAGGCGCTTGTC -> CCGCCGTAGGCGCTTGTCT
TTAGCACCTCCATGACCCG -> TAGCACCTCCATGACCCGT
ACTGTGTAGGCTATCTCTC -> CTGTGTAGGCTATCTCTCG
GTCGTTGGTTAGCACCTCC -> TCGTTGGTTAGCACCTCCA
ATTCGGTCTAAAGAACCGA -> TTCGGTCTAAAGAACCGAC
AATCCTTACACGAATATAG -> ATCCTTACACGAATATAGA
ACGCGGGTCTGCAGTGTCC -> CGCGGGTCTGCAGTGTCCT
GTACGGCATGTCGACGTAT -> TACGGCATGTCGACGTATA
GAAATCACGTAGCCTTGAT -> AAATCACGTAGCCTTGATC
AGCAACTTAAATTCGCCCA -> GCAACTTAAATTCGCCCAA
GCAGGTGTTACACACCGAC -> CAGGTGTTACACACCGACC
CATTCACCAGCGAAATCAC -> ATTCACCAGCGAAATCACG
TCTTGTGGAGAGCGGCGAT -> CTTGTGGAGAGCGGCGATT
ACACCCCAAATTATCCTGG -> CACCCCAAATTATCCTGGC
CCCGTAGGCGCTTGTCTTG -> CCGTAGGCGCTTGTCTTGC
CAGGTGTTACACACCGACC -> AGGTGTTACACACCGACCT
TGTGGACAGTCGTGGCCGT -> GTGGACAGTCGTGGCCGTA
CTTGGACACGGCCAGTCCT -> TTGGACACGGCCAGTCCTG
TGGCGATTTAATTGTATGC -> GGCGATTTAATTGTATGCC
CCTTAATCCTTACACGAAT -> CTTAATCCTTACACGAATA
AGAACGGCGTTGAATGGTT -> GAACGGCGTTGAATGGTTT
TGGCACAGGAACTAAGCGG -> GGCACAGGAACTAAGCGGG
GAAACGTATGGCTCTGCGT -> AAACGTATGGCTCTGCGTA
ATGAATGAAGACGCCCGCC -> TGAATGAAGACGCCCGCCC
TATTCGGTCTAAAGAACCG -> ATTCGGTCTAAAGAACCGA
CAAGAAACTTGGTTAGTGA -> AAGAAACTTGGTTAGTGAC
CTGCGGCACCGACCTTTAT -> TGCGGCACCGACCTTTATA
CCGAATTTGGACCACAGAT -> CGAATTTGGACCACAGATC
GTGTCCAATTCAACAGACG -> TGTCCAATTCAACAGACGG
CAAAGCCCGACCTACACAC -> AAAGCCCGACCTACACACC
ATGTTGGATCCTTGCGAAC -> TGTTGGATCCTTGCGAACT
CGCTTGTCTTGCCGGCCGT -> GCTTGTCTTGCCGGCCGTT
CTGCGTGCGTACTCTGTCT -> TGCGTGCGTACTCTGTCTC
TTGTGAGCGTGACGTCCTG -> TGTGAGCGTGACGTCCTGG
CCTGCGGCACCGACCTTTA -> CTGCGGCACCGACCTTTAT
TTCAGGCTGGGTCGGGTTC -> TCAGGCTGGGTCGGGTTCC
CTCGTCCAACCGCACGCCG -> TCGTCCAACCGCACGCCGA
GTGTATTCAACAATGTACG -> TGTATTCAACAATGTACGG
GGCCGTACATATCCTATCC -> GCCGTACATATCCTATCCT
TCAGGCTGGGTCGGGTTCC -> CAGGCTGGGTCGGGTTCCG
CAGAGCTGGGGGAGCAACT -> AGAGCTGGGGGAGCAACTT
TGCCCCTCGATGCAAGTAC -> GCCCCTCGATGCAAGTACT
GACCTTTATAGCATAATTA -> ACCTTTATAGCATAATTAG
TGGCGGACCACCTAGAACC -> GGCGGACCACCTAGAACCA
GCTTGTCTTGTGAGCGTGA -> CTTGTCTTGTGAGCGTGAC
GACCTTACCGCTGCGATGG -> ACCTTACCGCTGCGATGGC
TATCTGTGCACAAATTTAC -> ATCTGTGCACAAATTTACA
ACTCTGTCTCTTATTTGCC -> CTCTGTCTCTTATTTGCCC
CTATCATGAGACCTTGATT -> TATCATGAGACCTTGATTC
CTTTACGGGAGGATTCCGC -> TTTACGGGAGGATTCCGCT
AGGGTATCGGCTCCACGTC -> GGGTATCGGCTCCACGTCC
TCGGGACTGTGTAGGCTAT -> CGGGACTGTGTAGGCTATC
TTATCCTGGCATCTTCCGA -> TATCCTGGCATCTTCCGAC
CAGGCCGTGTAATGCATCA -> AGGCCGTGTAATGCATCAA
GCAAGATCGCACCAGGTGG -> CAAGATCGCACCAGGTGGC
AGTAGATACTCAGAGACGT -> GTAGATACTCAGAGACGTC
AAACGTATGGCTCTGCGTA -> AACGTATGGCTCTGCGTAT
TCGTACGGCATGTCGACGT -> CGTACGGCATGTCGACGTA
ACACCGACGTGAGGGTATC -> CACCGACGTGAGGGTATCG
AACGGTTCAACTTGGACCA -> ACGGTTCAACTTGGACCAC
AGGTGCAACCGAGGTGTAT -> GGTGCAACCGAGGTGTATT
CTTTTTGCAGTTAATCCAA -> TTTTTGCAGTTAATCCAAT
AATATACGAAACAAGACTA -> ATATACGAAACAAGACTAG
AGATCCTGGACAGCACGTC -> GATCCTGGACAGCACGTCA
GTATTTGGCCAACGACAAT -> TATTTGGCCAACGACAATC
CTAGGACAGCTCGACGCGA -> TAGGACAGCTCGACGCGAT
CTTGGCCAGGGACAGTTAG -> TTGGCCAGGGACAGTTAGC
CTTGTCTTGAGCCGCCGTA -> TTGTCTTGAGCCGCCGTAG
GCGGGTAAGTTCGATGCAA -> CGGGTAAGTTCGATGCAAT
GTGTCTGGCTTAATCTTAG -> TGTCTGGCTTAATCTTAGA
CCGCCGTAGGCGCTTGTCT -> CGCCGTAGGCGCTTGTCTT
AACTTGGACCACTTGGCCA -> ACTTGGACCACTTGGCCAG
AAGCGTATTTGGCCAACGA -> AGCGTATTTGGCCAACGAC
CCGTGCGGTCACATTTTTC -> CGTGCGGTCACATTTTTCC
GTGCGGTCACATTTTTCCT -> TGCGGTCACATTTTTCCTG
GAGAGCGGCGATTCGTGTC -> AGAGCGGCGATTCGTGTCT
GCGTGACGTCCTGGCACAG -> CGTGACGTCCTGGCACAGG
GGACAGCTCGACGCGATCT -> GACAGCTCGACGCGATCTT
ACAGGAACTAAGCGGGGCT -> CAGGAACTAAGCGGGGCTT
ATTTGCCCATGGTAGGTGT -> TTTGCCCATGGTAGGTGTC
TAGATTCATGGTCCTTCTA -> AGATTCATGGTCCTTCTAT
AGAACCACCCATTGCCCCT -> GAACCACCCATTGCCCCTC
AACTGCACTTTACCTCGAC -> ACTGCACTTTACCTCGACA
TTGGCCAACGACAATCAAA -> TGGCCAACGACAATCAAAG
GGGTTCCGGCGGTAGACCT -> GGTTCCGGCGGTAGACCTA
CGACGAATACCGAAAGGAG -> GACGAATACCGAAAGGAGT
CTACATAGGGTAGATCCTG -> TACATAGGGTAGATCCTGG
CCCCACATTGCCCTTGTAA -> CCCACATTGCCCTTGTAAT
TTGCCGGCCGTTAATCCTG -> TGCCGGCCGTTAATCCTGG
CTTGCTCATCCAAGCGCGC -> TTGCTCATCCAAGCGCGCG
CGTAGGCGCTTGTCTTGAG -> GTAGGCGCTTGTCTTGAGC
ACCGACCTTTATAGCATAA -> CCGACCTTTATAGCATAAT
AGACCCCCGGCACCGTACG -> GACCCCCGGCACCGTACGC
TGAAGACGCCCGCCCCGGT -> GAAGACGCCCGCCCCGGTG
GCCGGCCGTTAATCCTGGC -> CCGGCCGTTAATCCTGGCA
GACAGTCGTGGCCGTACAT -> ACAGTCGTGGCCGTACATA
AGATGGTCATTCCTGGCCC -> GATGGTCATTCCTGGCCCT
TAAATGGAACTGTCATTCA -> AAATGGAACTGTCATTCAC
GCCCTGCGGCACCGACCTT -> CCCTGCGGCACCGACCTTT
GCGGTCCAAATACCCTCAT -> CGGTCCAAATACCCTCATC
GGGGAGCAACTTAAATTCG -> GGGAGCAACTTAAATTCGC
TAAGTAGATACTCAGAGAC -> AAGTAGATACTCAGAGACG
TCCAACCGCACGCCGACGA -> CCAACCGCACGCCGACGAA
GAATACCGAAAGGAGTTTA -> AATACCGAAAGGAGTTTAT
TTCGTACGGCATGTCGACG -> TCGTACGGCATGTCGACGT
TTCGTGTCTGGCTTAATCT -> TCGTGTCTGGCTTAATCTT
CCGTAGGCGCTTGTCTTGG -> CGTAGGCGCTTGTCTTGGA
GCCCGACCTTAATCCTTAC -> CCCGACCTTAATCCTTACA
GCTCGACGCGATCTTTTGC -> CTCGACGCGATCTTTTGCA
ATGCCTTCGATGGCGGACC -> TGCCTTCGATGGCGGACCA
TTAATCCTGGCACAGGAAC -> TAATCCTGGCACAGGAACT
ATTCGCCCAAAGATGGTCA -> TTCGCCCAAAGATGGTCAT
CTGTGCACAAATTTACACC -> TGTGCACAAATTTACACCC
CTCAGAGCTGGGGGAGCAA -> TCAGAGCTGGGGGAGCAAC
CTGGCACAGGAACTAAGGG -> TGGCACAGGAACTAAGGGA
CTTCGATGGCGGACCACCT -> TTCGATGGCGGACCACCTA
CATCCAATGCCGCCAAGCA -> ATCCAATGCCGCCAAGCAT
CGCTCAGGCCATAGGTAAT -> GCTCAGGCCATAGGTAATC
TAGGCGCTTGTCTTGCCGG -> AGGCGCTTGTCTTGCCGGC
GTAGATACTCAGAGACGTC -> TAGATACTCAGAGACGTCG
GCCCCACATTGCCCTTGTA -> CCCCACATTGCCCTTGTAA
CTGCACGCTACACCGACGT -> TGCACGCTACACCGACGTG
GTATCTGTGCACAAATTTA -> TATCTGTGCACAAATTTAC
CACGTCCTCTTGTGGAGAG -> ACGTCCTCTTGTGGAGAGC
CTTTAGAGCTAAGTAGATA -> TTTAGAGCTAAGTAGATAC
ATACGAAACAAGACTAGTC -> TACGAAACAAGACTAGTCT
CCAACCGCACGCCGACGAA -> CAACCGCACGCCGACGAAT
GACAATCAAAGCCCGACCT -> ACAATCAAAGCCCGACCTA
ACGTAGCCTTGATCATGGT -> CGTAGCCTTGATCATGGTG
GCACCGTACGCAATTGAGC -> CACCGTACGCAATTGAGCG
GCGACTTGCCCTGCGGCAC -> CGACTTGCCCTGCGGCACC
CGGTCACATTTTTCCTGTA -> GGTCACATTTTTCCTGTAC
ACTGGACAAGCCTCTCGGA -> CTGGACAAGCCTCTCGGAG
CTCGCAAGAAAGACTCGTC -> TCGCAAGAAAGACTCGTCC
TGTAGGCTATCTCTCGAAA -> GTAGGCTATCTCTCGAAAC
TATTCAACAATGTACGGGC -> ATTCAACAATGTACGGGCC
CCCTTGTAATGCCCTCCGA -> CCTTGTAATGCCCTCCGAA
ATCCAAGCGCGCGCCCATT -> TCCAAGCGCGCGCCCATTA
AGGTGGCTTTAGAGCTAAG -> GGTGGCTTTAGAGCTAAGT
CAACGACAATCAAAGCCCG -> AACGACAATCAAAGCCCGA
AGGGCTGGCGATTTAATTG -> GGGCTGGCGATTTAATTGT
CTCCAGGACTAAGGGCTGG -> TCCAGGACTAAGGGCTGGC
TAAACACCCCAAATTATCC -> AAACACCCCAAATTATCCT
TGTAATGCATCAATTAGAG -> GTAATGCATCAATTAGAGG
CGGCGATTCGTGTCTGGCT -> GGCGATTCGTGTCTGGCTT
CACCTATTCGGTCTAAAGA -> ACCTATTCGGTCTAAAGAA
GCAGTTAATCCAATTGTAT -> CAGTTAATCCAATTGTATT
TCTTTAAACTGGACAAGCC -> CTTTAAACTGGACAAGCCT
AATTTATGTGGACAGTCGT -> ATTTATGTGGACAGTCGTG
AATTAGAGGTGCATATCTT -> ATTAGAGGTGCATATCTTT
AAAGAACCGACCCTGATGT -> AAGAACCGACCCTGATGTT
CCGACAGGCAACCGTAGGC -> CGACAGGCAACCGTAGGCG
TCCCCGAAACGTATGGCTC -> CCCCGAAACGTATGGCTCT
TACCGTACATAACATAGGT -> ACCGTACATAACATAGGTC
AATGGTTTTAAGCCGAGGT -> ATGGTTTTAAGCCGAGGTC
CGGACTGCCCTGCTTGGGT -> GGACTGCCCTGCTTGGGTG
ACAATCACCGTCTGGCCCG -> CAATCACCGTCTGGCCCGA
CCTCGATGCAAGTACTGTG -> CTCGATGCAAGTACTGTGG
TGGTTAGTGACCTTACCGC -> GGTTAGTGACCTTACCGCT
GGTCCTTCTATATCCGTAG -> GTCCTTCTATATCCGTAGG
TGCAGTTAATCCAATTGTA -> GCAGTTAATCCAATTGTAT
ATTCGTACGGCATGTCGAC -> TTCGTACGGCATGTCGACG
CACCGCGGGCCTGATGGTG -> ACCGCGGGCCTGATGGTGC
CTTGTGGAGAGCGGCGATT -> TTGTGGAGAGCGGCGATTC
GTATAGAACGGCGTTGAAT -> TATAGAACGGCGTTGAATG
TTGCCCCTCGATGCAAGTA -> TGCCCCTCGATGCAAGTAC
CCAGTGTAGACTTTTTGCA -> CAGTGTAGACTTTTTGCAG
CCCTGACCCTTATCTTGCC -> CCTGACCCTTATCTTGCCG
CCGACGTGAGGGTATCGGC -> CGACGTGAGGGTATCGGCT
ACTCAGGCCGTGTAATGCA -> CTCAGGCCGTGTAATGCAT
ATGGTCCTTCTATATCCGT -> TGGTCCTTCTATATCCGTA
CCGACCTGGGACTGACGCC -> CGACCTGGGACTGACGCCG
GTAGACTTTTTGCAGTTAA -> TAGACTTTTTGCAGTTAAT
CCTTACCGCTGCGATGGCA -> CTTACCGCTGCGATGGCAG
GCTTAATCTTAGAGCGCCG -> CTTAATCTTAGAGCGCCGA
AAGGAGTTTATCCTGTGGG -> AGGAGTTTATCCTGTGGGC
CGTCCAACCGCACGCCGAC -> GTCCAACCGCACGCCGACG
ACTGACGCCGCTCAGGCCA -> CTGACGCCGCTCAGGCCAT
GGAGTAGATCTTGGCAAGC -> GAGTAGATCTTGGCAAGCA
CGCGGGTAAGTTCGATGCA -> GCGGGTAAGTTCGATGCAA
GACCCGTAGGCGCTTGTCT -> ACCCGTAGGCGCTTGTCTT
TCCTGGCATCTTCCGACGA -> CCTGGCATCTTCCGACGAT
GCGCCAGTCTAGTGGCTGC -> CGCCAGTCTAGTGGCTGCA
GCTTGGGTGTATAATTTAT -> CTTGGGTGTATAATTTATG
TCGACATCTGGCGCGGGTA -> CGACATCTGGCGCGGGTAA
TTCCTGGCCCTCGCAAGAA -> TCCTGGCCCTCGCAAGAAA
CAATGCCGCCAAGCATCTC -> AATGCCGCCAAGCATCTCA
CACCCATTGCCCCTCGATG -> ACCCATTGCCCCTCGATGC
AGGCAACCGTAGGCGCTTG -> GGCAACCGTAGGCGCTTGT
ATTACCCCTCCTATTAGTC -> TTACCCCTCCTATTAGTCT
GCCGTGTAATGCATCAATT -> CCGTGTAATGCATCAATTA
GGTGGCTTTAGAGCTAAGT -> GTGGCTTTAGAGCTAAGTA
TATCCTCAGCGCGTCCGTC -> ATCCTCAGCGCGTCCGTCG
GGTCTGCAGTGTCCTCTGA -> GTCTGCAGTGTCCTCTGAC
GCGCGTCCGTCGACTATAC -> CGCGTCCGTCGACTATACC
AAGTCGTCCAGATCCCTGC -> AGTCGTCCAGATCCCTGCA
CAACATATGTGCATAGCAT -> AACATATGTGCATAGCATG
AGCGCGTCCGTCGACTATA -> GCGCGTCCGTCGACTATAC
TAGACTTTTTGCAGTTAAT -> AGACTTTTTGCAGTTAATC
ATCTTTAAACTGGACAAGC -> TCTTTAAACTGGACAAGCC
GTTGGTTAGCACCTCCATG -> TTGGTTAGCACCTCCATGA
TTGCGAACTGCGTGCGTAC -> TGCGAACTGCGTGCGTACT
TAGGCGCTTGTCTTGTGAG -> AGGCGCTTGTCTTGTGAGC
TGCCCTCCGAATTTGGACC -> GCCCTCCGAATTTGGACCA
AGTCCTGGCACAGGAACTA -> GTCCTGGCACAGGAACTAA
TAACATAGGTCACCTATTC -> AACATAGGTCACCTATTCG
TTGCATTACCCCTCCTATT -> TGCATTACCCCTCCTATTA
CTCAGGCCATAGGTAATCC -> TCAGGCCATAGGTAATCCG
CTGGACAGCACGTCACGTA -> TGGACAGCACGTCACGTAG
TGCGAACTGCGTGCGTACT -> GCGAACTGCGTGCGTACTC
CCACTTGCTCATCCAAGCG -> CACTTGCTCATCCAAGCGC
CCATTGCCCCTCGATGCAA -> CATTGCCCCTCGATGCAAG
CAGTTCCTGGCGAAATATA -> AGTTCCTGGCGAAATATAC
GTGGCTTTAGAGCTAAGTA -> TGGCTTTAGAGCTAAGTAG
GAACTGCGTGCGTACTCTG -> AACTGCGTGCGTACTCTGT
GACGTATAGGTTTGATGGT -> ACGTATAGGTTTGATGGTT
TTGTCTTGAGCCGCCGTAG -> TGTCTTGAGCCGCCGTAGG
CCGGCGGTAGACCTAAATG -> CGGCGGTAGACCTAAATGG
GACACCGCGGGCCTGATGG -> ACACCGCGGGCCTGATGGT
CACGTAGTCACGAGGTCGA -> ACGTAGTCACGAGGTCGAT
ATTAGGCGCTCATACCGTA -> TTAGGCGCTCATACCGTAC
GCCGCGTAACATTAGTAAT -> CCGCGTAACATTAGTAATG
CTGTGGGCAGTTCCTGGCG -> TGTGGGCAGTTCCTGGCGA
TGGAAGTATCTGTGCACAA -> GGAAGTATCTGTGCACAAA
CCTGCTTGGGTGTATAATT -> CTGCTTGGGTGTATAATTT
GACACGGCCAGTCCTGGCA -> ACACGGCCAGTCCTGGCAC
TGGACACGGCCAGTCCTGG -> GGACACGGCCAGTCCTGGC
ACCTTGATTCGTACGGCAT -> CCTTGATTCGTACGGCATG
GGCATGTCGACGTATAGGT -> GCATGTCGACGTATAGGTT
GACTTTTTGCAGTTAATCC -> ACTTTTTGCAGTTAATCCA
CGCAAGAAAGACTCGTCCA -> GCAAGAAAGACTCGTCCAA
CAGTCCTGGCACAGGAACT -> AGTCCTGGCACAGGAACTA
ACACCGTTGGTGTCTGATA -> CACCGTTGGTGTCTGATAC
CGGCCAGTCCTGGCACAGG -> GGCCAGTCCTGGCACAGGA
AACCCTTCTTAACGTTGTC -> ACCCTTCTTAACGTTGTCA
CTTGTCTTGTGAGCGTGAC -> TTGTCTTGTGAGCGTGACG
TACTCAGAGACGTCGTTGG -> ACTCAGAGACGTCGTTGGT
CGAAATATACGAAACAAGA -> GAAATATACGAAACAAGAC
CGCCGACAGGCAACCGTAG -> GCCGACAGGCAACCGTAGG
GGCTCTGCGTATAGAACGG -> GCTCTGCGTATAGAACGGC
CTATATCCGTAGGCGCTTG -> TATATCCGTAGGCGCTTGT
GAGAACAAAGGGACGCGCC -> AGAACAAAGGGACGCGCCA
CACCGTCTGGCCCGACCTT -> ACCGTCTGGCCCGACCTTA
TACACACCGACCTGGGACT -> ACACACCGACCTGGGACTG
GATAGCAAGAAACTTGGTT -> ATAGCAAGAAACTTGGTTA
GGTAAGTTCGATGCAATGC -> GTAAGTTCGATGCAATGCC
CTAGCGTGTCGGCTGCGAC -> TAGCGTGTCGGCTGCGACT
TGTGCACAAATTTACACCC -> GTGCACAAATTTACACCCT
ACGTAGTCACGAGGTCGAT -> CGTAGTCACGAGGTCGATA
ACCAAGACCCCCGGCACCG -> CCAAGACCCCCGGCACCGT
GGAGTTTATCCTGTGGGCA -> GAGTTTATCCTGTGGGCAG
CCTCGCAAGAAAGACTCGT -> CTCGCAAGAAAGACTCGTC
CAAGACCCCCGGCACCGTA -> AAGACCCCCGGCACCGTAC
GTCCTGGCACAGGAACTAA -> TCCTGGCACAGGAACTAAG, TCCTGGCACAGGAACTAAG
CGAAACAAGACTAGTCTTC -> GAAACAAGACTAGTCTTCA
GTGATAGGATCCCCGAAAC -> TGATAGGATCCCCGAAACG
AATTGTATTCTGCCCCACA -> ATTGTATTCTGCCCCACAT
GTTGGATCCTTGCGAACTG -> TTGGATCCTTGCGAACTGC
TAGGTAATCCGGTGATAGG -> AGGTAATCCGGTGATAGGA
AAATTCGCCCAAAGATGGT -> AATTCGCCCAAAGATGGTC
TAGGTCACCTATTCGGTCT -> AGGTCACCTATTCGGTCTA
GCAACATATGTGCATAGCA -> CAACATATGTGCATAGCAT
GCCCATTACCGCTTTACGG -> CCCATTACCGCTTTACGGG
AACACCCCAAATTATCCTG -> ACACCCCAAATTATCCTGG
ACCCATTGCCCCTCGATGC -> CCCATTGCCCCTCGATGCA
TTTATGTGGACAGTCGTGG -> TTATGTGGACAGTCGTGGC
ATAGGTCACCTATTCGGTC -> TAGGTCACCTATTCGGTCT
CCCCGAAACGTATGGCTCT -> CCCGAAACGTATGGCTCTG
TCCTCAGCGCGTCCGTCGA -> CCTCAGCGCGTCCGTCGAC
TATTTGCCCATGGTAGGTG -> ATTTGCCCATGGTAGGTGT
TCGGCTCCACGTCCTCTTG -> CGGCTCCACGTCCTCTTGT
CACCAGGTGGCTTTAGAGC -> ACCAGGTGGCTTTAGAGCT
CGGGACTGTGTAGGCTATC -> GGGACTGTGTAGGCTATCT
AAGGGCTGGCGATTTAATT -> AGGGCTGGCGATTTAATTG
GGCGGACCACCTAGAACCA -> GCGGACCACCTAGAACCAC
GGAACTAAGGTTATACCTC -> GAACTAAGGTTATACCTCG
ATGGTCATTCCTGGCCCTC -> TGGTCATTCCTGGCCCTCG
ACTTGCCCTGCGGCACCGA -> CTTGCCCTGCGGCACCGAC
AAGCCGAGGTCGCTCCAGG -> AGCCGAGGTCGCTCCAGGA
TACCCTCATCCAATGCCGC -> ACCCTCATCCAATGCCGCC
TGCTTGGGTGTATAATTTA -> GCTTGGGTGTATAATTTAT
TAATCCAATTGTATTCTGC -> AATCCAATTGTATTCTGCC
CTGGACAAGCCTCTCGGAG -> TGGACAAGCCTCTCGGAGT
ATATAGATTCATGGTCCTT -> TATAGATTCATGGTCCTTC
CCAGCAGGTGTTACACACC -> CAGCAGGTGTTACACACCG
AAGACTCGTCCAACCGCAC -> AGACTCGTCCAACCGCACG
GCACACCAAGACCCCCGGC -> CACACCAAGACCCCCGGCA
CGCGCCCATTACCGCTTTA -> GCGCCCATTACCGCTTTAC
GCTTGTCTTGCCGGCCGTT -> CTTGTCTTGCCGGCCGTTA
TTAACGTTGTCACCGTAGG -> TAACGTTGTCACCGTAGGA
GGGAGAACAAAGGGACGCG -> GGAGAACAAAGGGACGCGC
TTTTAAGCCGAGGTCGCTC -> TTTAAGCCGAGGTCGCTCC
AAGCCAAGTTCGGGACTGT -> AGCCAAGTTCGGGACTGTG
AAGTATCTGTGCACAAATT -> AGTATCTGTGCACAAATTT
CCCTGCGGCACCGACCTTT -> CCTGCGGCACCGACCTTTA
TATTAGTCTTAAGTCGTCC -> ATTAGTCTTAAGTCGTCCA
ATTAGAGGTGCATATCTTT -> TTAGAGGTGCATATCTTTA
CCCTTATCTTGCCGCGCCG -> CCTTATCTTGCCGCGCCGT
TCCAGTGTAGACTTTTTGC -> CCAGTGTAGACTTTTTGCA
ACAATCAAAGCCCGACCTA -> CAATCAAAGCCCGACCTAC
CTAAGCGGGGCTTCCTGGC -> TAAGCGGGGCTTCCTGGCA
GAATGGTTTTAAGCCGAGG -> AATGGTTTTAAGCCGAGGT
GCCGACAGGCAACCGTAGG -> CCGACAGGCAACCGTAGGC
CACCTCCATGACCCGTAGG -> ACCTCCATGACCCGTAGGC
GTTCAACTTGGACCACTTG -> TTCAACTTGGACCACTTGG
GCATAATTAGGCGCTCATA -> CATAATTAGGCGCTCATAC
GGCAAGCAAGATCGCACCA -> GCAAGCAAGATCGCACCAG
TAGCATGTCCAGTGTAGAC -> AGCATGTCCAGTGTAGACT
ATCCCCGAAACGTATGGCT -> TCCCCGAAACGTATGGCTC
CAACAGACGGACTGCCCTG -> AACAGACGGACTGCCCTGC
GCAACTTAAATTCGCCCAA -> CAACTTAAATTCGCCCAAA
TTTGCAACTGCACTTTACC -> TTGCAACTGCACTTTACCT
ACCACAGATCCATGAATGA -> CCACAGATCCATGAATGAA
CTTAACGTTGTCACCGTAG -> TTAACGTTGTCACCGTAGG
CCCATTGCCCCTCGATGCA -> CCATTGCCCCTCGATGCAA
CGACCTTTATAGCATAATT -> GACCTTTATAGCATAATTA
ATCACAATCACCGTCTGGC -> TCACAATCACCGTCTGGCC
AGGTCGCTCCAGGACTAAG -> GGTCGCTCCAGGACTAAGG
GGCACAGGAACTAAGGGAG -> GCACAGGAACTAAGGGAGA
AGTACTGTGGCAAGGATCA -> GTACTGTGGCAAGGATCAC
TGGCACAGGAACTAAGGAA -> GGCACAGGAACTAAGGAAC
CAATGCCTTCGATGGCGGA -> AATGCCTTCGATGGCGGAC
TAATCCTGGCACAGGAACT -> AATCCTGGCACAGGAACTA
CCTGGACAGCACGTCACGT -> CTGGACAGCACGTCACGTA
CTAAGTAGATACTCAGAGA -> TAAGTAGATACTCAGAGAC
TATTTGGCCAACGACAATC -> ATTTGGCCAACGACAATCA
TTACCGCTTTACGGGAGGA -> TACCGCTTTACGGGAGGAT
TTGGTGTCTGATACTCAGA -> TGGTGTCTGATACTCAGAG
ACCTAGAACCACCCATTGC -> CCTAGAACCACCCATTGCC
TGCACAAATTTACACCCTC -> GCACAAATTTACACCCTCT
GGAAATAGCCCTGACCCTT -> GAAATAGCCCTGACCCTTA
TATGGCTCTGCGTATAGAA -> ATGGCTCTGCGTATAGAAC
AGGTGTATTCAACAATGTA -> GGTGTATTCAACAATGTAC
TTGTATGCCCTATCATGAG -> TGTATGCCCTATCATGAGA
CTTAATCTTAGAGCGCCGA -> TTAATCTTAGAGCGCCGAC
TGAGCGTCACTTAAACACC -> GAGCGTCACTTAAACACCC
GTCACCTATTCGGTCTAAA -> TCACCTATTCGGTCTAAAG
AAGTTCGGGACTGTGTAGG -> AGTTCGGGACTGTGTAGGC
TGAGCCGCCGTAGGCGCTT -> GAGCCGCCGTAGGCGCTTG
GCCCCGGTGCCAGCAGGTG -> CCCCGGTGCCAGCAGGTGT
CGTGGCCGTACATATCCTA -> GTGGCCGTACATATCCTAT
ACGCTACACCGACGTGAGG -> CGCTACACCGACGTGAGGG
CCGTACATAACATAGGTCA -> CGTACATAACATAGGTCAC
ATTCAACAGACGGACTGCC -> TTCAACAGACGGACTGCCC
CCCGGCACCGTACGCAATT -> CCGGCACCGTACGCAATTG
AGACGCCCGCCCCGGTGCC -> GACGCCCGCCCCGGTGCCA
ACCGCTTTACGGGAGGATT -> CCGCTTTACGGGAGGATTC
TCACGTAGTCACGAGGTCG -> CACGTAGTCACGAGGTCGA
GCGTCACTTAAACACCCCA -> CGTCACTTAAACACCCCAA
ATATGTGCATAGCATGTCC -> TATGTGCATAGCATGTCCA
TCTTATTTGCCCATGGTAG -> CTTATTTGCCCATGGTAGG
CCCTCCTATTAGTCTTAAG -> CCTCCTATTAGTCTTAAGT
ATGGTGCACACCAAGACCC -> TGGTGCACACCAAGACCCC
GCTCTGCGTATAGAACGGC -> CTCTGCGTATAGAACGGCG
CAAATTTACACCCTCTAAG -> AAATTTACACCCTCTAAGC
CACGCTACACCGACGTGAG -> ACGCTACACCGACGTGAGG
TGGCCCGACCTTAATCCTT -> GGCCCGACCTTAATCCTTA
ATCTGTGCACAAATTTACA -> TCTGTGCACAAATTTACAC
CTCTAAGCGTATTTGGCCA -> TCTAAGCGTATTTGGCCAA
TTTAGAGCTAAGTAGATAC -> TTAGAGCTAAGTAGATACT
CTCTGCGTATAGAACGGCG -> TCTGCGTATAGAACGGCGT
ATCCAATTGTATTCTGCCC -> TCCAATTGTATTCTGCCCC
TCGACTATACCGGTTACGC -> CGACTATACCGGTTACGCG
TGATGGTGCACACCAAGAC -> GATGGTGCACACCAAGACC
ACCGACCTGGGACTGACGC -> CCGACCTGGGACTGACGCC
CTTGCCGCGCCGTGCGGTC -> TTGCCGCGCCGTGCGGTCA
GGAACCCTTCTTAACGTTG -> GAACCCTTCTTAACGTTGT
GGACAGTCGTGGCCGTACA -> GACAGTCGTGGCCGTACAT
CCCGAAACGTATGGCTCTG -> CCGAAACGTATGGCTCTGC
TTACCCCTCCTATTAGTCT -> TACCCCTCCTATTAGTCTT
CACGGCCAGTCCTGGCACA -> ACGGCCAGTCCTGGCACAG
CAGGAACTAAGGGAGAACA -> AGGAACTAAGGGAGAACAA
TAGCGTGTCGGCTGCGACT -> AGCGTGTCGGCTGCGACTT
CGGTCTAAAGAACCGACCC -> GGTCTAAAGAACCGACCCT
CCCTCTAAGCGTATTTGGC -> CCTCTAAGCGTATTTGGCC
AACCGTAGGCGCTTGTCTT -> ACCGTAGGCGCTTGTCTTG
GTGTTACACACCGACCTGG -> TGTTACACACCGACCTGGG
CATCAATTAGAGGTGCATA -> ATCAATTAGAGGTGCATAT
CTAGTGGCTGCACGCTACA -> TAGTGGCTGCACGCTACAC
ACTTGCTCATCCAAGCGCG -> CTTGCTCATCCAAGCGCGC
ATAGCATGTCCAGTGTAGA -> TAGCATGTCCAGTGTAGAC
GGAGGATTCCGCTAGCGTG -> GAGGATTCCGCTAGCGTGT
CGCCCGCCCCGGTGCCAGC -> GCCCGCCCCGGTGCCAGCA
AGAGGTGCATATCTTTAAA -> GAGGTGCATATCTTTAAAC
GTCATTCCTGGCCCTCGCA -> TCATTCCTGGCCCTCGCAA
CCTGGCATCTTCCGACGAT -> CTGGCATCTTCCGACGATC
TCCAATTGTATTCTGCCCC -> CCAATTGTATTCTGCCCCA
GCGAAATCACGTAGCCTTG -> CGAAATCACGTAGCCTTGA
TCTTAACGTTGTCACCGTA -> CTTAACGTTGTCACCGTAG
GTATGGCTCTGCGTATAGA -> TATGGCTCTGCGTATAGAA
CGTGACGTCCTGGCACAGG -> GTGACGTCCTGGCACAGGA
CGCGATCTTTTGCAACTGC -> GCGATCTTTTGCAACTGCA
TGGACAGTCGTGGCCGTAC -> GGACAGTCGTGGCCGTACA
TTGCAACTGCACTTTACCT -> TGCAACTGCACTTTACCTC
GGCGAAATATACGAAACAA -> GCGAAATATACGAAACAAG
GGTATCGGCTCCACGTCCT -> GTATCGGCTCCACGTCCTC
AACATTAGTAATGGAAGTA -> ACATTAGTAATGGAAGTAT
CAGTCGTGGCCGTACATAT -> AGTCGTGGCCGTACATATC
AACAAGACTAGTCTTCAGG -> ACAAGACTAGTCTTCAGGC
CGTAACATTAGTAATGGAA -> GTAACATTAGTAATGGAAG
CAACTTAAATTCGCCCAAA -> AACTTAAATTCGCCCAAAG
CCGACCTTTATAGCATAAT -> CGACCTTTATAGCATAATT
CGGCTGCGACTTGCCCTGC -> GGCTGCGACTTGCCCTGCG
CACAGGAACTAAGCGGGGC -> ACAGGAACTAAGCGGGGCT
CAAGAAAGACTCGTCCAAC -> AAGAAAGACTCGTCCAACC
CAAGATCGCACCAGGTGGC -> AAGATCGCACCAGGTGGCT
TCGATGCAAGTACTGTGGC -> CGATGCAAGTACTGTGGCA
CTTCTTAACGTTGTCACCG -> TTCTTAACGTTGTCACCGT
TAGAGGTGCATATCTTTAA -> AGAGGTGCATATCTTTAAA
TTTAATTGTATGCCCTATC -> TTAATTGTATGCCCTATCA
CACATTGCCCTTGTAATGC -> ACATTGCCCTTGTAATGCC
AAGGAACCCTTCTTAACGT -> AGGAACCCTTCTTAACGTT
CGGTTCAACTTGGACCACT -> GGTTCAACTTGGACCACTT
CGACAGGCAACCGTAGGCG -> GACAGGCAACCGTAGGCGC
CGCTAGCGTGTCGGCTGCG -> GCTAGCGTGTCGGCTGCGA
TGCAACCGAGGTGTATTCA -> GCAACCGAGGTGTATTCAA
AACCGACCCTGATGTTGGA -> ACCGACCCTGATGTTGGAT
GATGTTGGATCCTTGCGAA -> ATGTTGGATCCTTGCGAAC
AGGCCGTGTAATGCATCAA -> GGCCGTGTAATGCATCAAT
ATGTACGGGCCAGCAGATA -> TGTACGGGCCAGCAGATAA
CACAGGAACTAAGGGAGAA -> ACAGGAACTAAGGGAGAAC
AACTGGACAAGCCTCTCGG -> ACTGGACAAGCCTCTCGGA
ATCCTTACACGAATATAGA -> TCCTTACACGAATATAGAT
CTTGTCTTGGACACGGCCA -> TTGTCTTGGACACGGCCAG
CCGAAAGGAGTTTATCCTG -> CGAAAGGAGTTTATCCTGT
GCGTGTCGGCTGCGACTTG -> CGTGTCGGCTGCGACTTGC
CTTACACGAATATAGATTC -> TTACACGAATATAGATTCA
TGTCTTGCCGGCCGTTAAT -> GTCTTGCCGGCCGTTAATC
TTTGATGGTTTAGGTGCAA -> TTGATGGTTTAGGTGCAAC
GTATCGGCTCCACGTCCTC -> TATCGGCTCCACGTCCTCT
AGGTTATACCTCGGCGGTC -> GGTTATACCTCGGCGGTCC
ACTTAAACACCCCAAATTA -> CTTAAACACCCCAAATTAT
AGTATCTGTGCACAAATTT -> GTATCTGTGCACAAATTTA
GACGCCGCTCAGGCCATAG -> ACGCCGCTCAGGCCATAGG
AAGGGAGAACAAAGGGACG -> AGGGAGAACAAAGGGACGC
CCTCAGCGCGTCCGTCGAC -> CTCAGCGCGTCCGTCGACT
GTGCATATCTTTAAACTGG -> TGCATATCTTTAAACTGGA
GCAAGGATCACAATCACCG -> CAAGGATCACAATCACCGT
TGTCCAGTGTAGACTTTTT -> GTCCAGTGTAGACTTTTTG
GGTTCCGGCGGTAGACCTA -> GTTCCGGCGGTAGACCTAA
GCGATTTAATTGTATGCCC -> CGATTTAATTGTATGCCCT
TACATATCCTATCCTCAGC -> ACATATCCTATCCTCAGCG
TTAAATTCGCCCAAAGATG -> TAAATTCGCCCAAAGATGG
CGATTCGTGTCTGGCTTAA -> GATTCGTGTCTGGCTTAAT
GTCCTCTTGTGGAGAGCGG -> TCCTCTTGTGGAGAGCGGC
TTAATTGTATGCCCTATCA -> TAATTGTATGCCCTATCAT
CTAAGGTTATACCTCGGCG -> TAAGGTTATACCTCGGCGG
AGAGCGCCGACAGGCAACC -> GAGCGCCGACAGGCAACCG
TCAGGCCGTGTAATGCATC -> CAGGCCGTGTAATGCATCA
TAGCCCTGACCCTTATCTT -> AGCCCTGACCCTTATCTTG
ACCCTCATCCAATGCCGCC -> CCCTCATCCAATGCCGCCA
GCACAGGAACTAAGGGAGA -> CACAGGAACTAAGGGAGAA
CCGCACTAGGACAGCTCGA -> CGCACTAGGACAGCTCGAC
ATCATGAGACCTTGATTCG -> TCATGAGACCTTGATTCGT
GACAGCTCGACGCGATCTT -> ACAGCTCGACGCGATCTTT
CCCCGGCACCGTACGCAAT -> CCCGGCACCGTACGCAATT
ACAGGAACTAAGGTTATAC -> CAGGAACTAAGGTTATACC
TCTTCCGACGATCTTGCAT -> CTTCCGACGATCTTGCATT
CATTTTTCCTGTACTCAGG -> ATTTTTCCTGTACTCAGGC
TAATGCATCAATTAGAGGT -> AATGCATCAATTAGAGGTG
GGCGTTGAATGGTTTTAAG -> GCGTTGAATGGTTTTAAGC
GTCGTCCAGATCCCTGCAA -> TCGTCCAGATCCCTGCAAC
GCAGTGTCCTCTGACTACA -> CAGTGTCCTCTGACTACAT
GCCCTGACCCTTATCTTGC -> CCCTGACCCTTATCTTGCC
CCAAGCATCTCATTTTCGT -> CAAGCATCTCATTTTCGTC
ACTAAGGAACCCTTCTTAA -> CTAAGGAACCCTTCTTAAC
CAAGTACTGTGGCAAGGAT -> AAGTACTGTGGCAAGGATC
CCCATTACCGCTTTACGGG -> CCATTACCGCTTTACGGGA
ACGCGCCAGTCTAGTGGCT -> CGCGCCAGTCTAGTGGCTG
ATGCAATGCCTTCGATGGC -> TGCAATGCCTTCGATGGCG
GCCCCTCGATGCAAGTACT -> CCCCTCGATGCAAGTACTG
CCTACACACCGTTGGTGTC -> CTACACACCGTTGGTGTCT
GGTCGCTCCAGGACTAAGG -> GTCGCTCCAGGACTAAGGG
TTTTTCCTGTACTCAGGCC -> TTTTCCTGTACTCAGGCCG
GCATGTCGACGTATAGGTT -> CATGTCGACGTATAGGTTT
AGCAAGATCGCACCAGGTG -> GCAAGATCGCACCAGGTGG
TAGCATAATTAGGCGCTCA -> AGCATAATTAGGCGCTCAT
ACTAAGGGCTGGCGATTTA -> CTAAGGGCTGGCGATTTAA
CTATTCGGTCTAAAGAACC -> TATTCGGTCTAAAGAACCG
ATCCTTGCGAACTGCGTGC -> TCCTTGCGAACTGCGTGCG
GGCACCGACCTTTATAGCA -> GCACCGACCTTTATAGCAT
TGATGTTGGATCCTTGCGA -> GATGTTGGATCCTTGCGAA
TACATAACATAGGTCACCT -> ACATAACATAGGTCACCTA
CTGCAACATATGTGCATAG -> TGCAACATATGTGCATAGC
GATTTAATTGTATGCCCTA -> ATTTAATTGTATGCCCTAT
ACGCGATCTTTTGCAACTG -> CGCGATCTTTTGCAACTGC
GATGGTTTAGGTGCAACCG -> ATGGTTTAGGTGCAACCGA
ATCAAAGCCCGACCTACAC -> TCAAAGCCCGACCTACACA
TGGTTTAGGTGCAACCGAG -> GGTTTAGGTGCAACCGAGG
AGGAACCCTTCTTAACGTT -> GGAACCCTTCTTAACGTTG
ACAGTTAGCCGCGTAACAT -> CAGTTAGCCGCGTAACATT
GGTCTAAAGAACCGACCCT -> GTCTAAAGAACCGACCCTG
CTGACTACATAGGGTAGAT -> TGACTACATAGGGTAGATC
CATTAGTAATGGAAGTATC -> ATTAGTAATGGAAGTATCT
TTCCTGTACTCAGGCCGTG -> TCCTGTACTCAGGCCGTGT
GCTTTAGAGCTAAGTAGAT -> CTTTAGAGCTAAGTAGATA
GTACTGTGGCAAGGATCAC -> TACTGTGGCAAGGATCACA
TCGTGTCTGGCTTAATCTT -> CGTGTCTGGCTTAATCTTA
TGTATTCAACAATGTACGG -> GTATTCAACAATGTACGGG
CGAAACGTATGGCTCTGCG -> GAAACGTATGGCTCTGCGT
GCCGACGAATACCGAAAGG -> CCGACGAATACCGAAAGGA
CCTTCGATGGCGGACCACC -> CTTCGATGGCGGACCACCT
CGCTTGTCTTGTGAGCGTG -> GCTTGTCTTGTGAGCGTGA
CGAATACCGAAAGGAGTTT -> GAATACCGAAAGGAGTTTA
TTGCTCATCCAAGCGCGCG -> TGCTCATCCAAGCGCGCGC
AAGATGGTCATTCCTGGCC -> AGATGGTCATTCCTGGCCC
TTGGTTAGCACCTCCATGA -> TGGTTAGCACCTCCATGAC
AGGAACTAAGGAACCCTTC -> GGAACTAAGGAACCCTTCT
TGTCTTGTGAGCGTGACGT -> GTCTTGTGAGCGTGACGTC
GAACCACCCATTGCCCCTC -> AACCACCCATTGCCCCTCG
AATTATCCTGGCATCTTCC -> ATTATCCTGGCATCTTCCG
AACGGCGTTGAATGGTTTT -> ACGGCGTTGAATGGTTTTA
ACGGCGTTGAATGGTTTTA -> CGGCGTTGAATGGTTTTAA
GCGCCGACAGGCAACCGTA -> CGCCGACAGGCAACCGTAG
CCCATGGTAGGTGTCCAAT -> CCATGGTAGGTGTCCAATT
CCTGGGACTGACGCCGCTC -> CTGGGACTGACGCCGCTCA
GTGACGTCCTGGCACAGGA -> TGACGTCCTGGCACAGGAA
CTTGAGCCGCCGTAGGCGC -> TTGAGCCGCCGTAGGCGCT
GCGTATAGAACGGCGTTGA -> CGTATAGAACGGCGTTGAA
ATCTCATTTTCGTCCACTT -> TCTCATTTTCGTCCACTTG
GATTCGTGTCTGGCTTAAT -> ATTCGTGTCTGGCTTAATC
TCTGGCCCGACCTTAATCC -> CTGGCCCGACCTTAATCCT
ATACCGGTTACGCGGGTCT -> TACCGGTTACGCGGGTCTG
ACGTTGTCACCGTAGGAAG -> CGTTGTCACCGTAGGAAGC
CTCTTATTTGCCCATGGTA -> TCTTATTTGCCCATGGTAG
GTACGCAATTGAGCGTCAC -> TACGCAATTGAGCGTCACT
GACCACCTAGAACCACCCA -> ACCACCTAGAACCACCCAT
GAGCCGCCGTAGGCGCTTG -> AGCCGCCGTAGGCGCTTGT
CGTACATAACATAGGTCAC -> GTACATAACATAGGTCACC
AGAGCTGGGGGAGCAACTT -> GAGCTGGGGGAGCAACTTA
ACGGCCAGTCCTGGCACAG -> CGGCCAGTCCTGGCACAGG
CTTCAGGCTGGGTCGGGTT -> TTCAGGCTGGGTCGGGTTC
CGCACCAGGTGGCTTTAGA -> GCACCAGGTGGCTTTAGAG
GGCTATCTCTCGAAACGGT -> GCTATCTCTCGAAACGGTT
TAGTCACGAGGTCGATAGC -> AGTCACGAGGTCGATAGCA
ACTTGGCCAGGGACAGTTA -> CTTGGCCAGGGACAGTTAG
CCTGACCCTTATCTTGCCG -> CTGACCCTTATCTTGCCGC
TTTGCAGTTAATCCAATTG -> TTGCAGTTAATCCAATTGT
GTGCTAGGAAATAGCCCTG -> TGCTAGGAAATAGCCCTGA
GCACAAATTTACACCCTCT -> CACAAATTTACACCCTCTA
GTGTCTGATACTCAGAGCT -> TGTCTGATACTCAGAGCTG
GCCGAGGTCGCTCCAGGAC -> CCGAGGTCGCTCCAGGACT
TCACCAGCGAAATCACGTA -> CACCAGCGAAATCACGTAG
ACACACCGTTGGTGTCTGA -> CACACCGTTGGTGTCTGAT
ATCTTGCATTACCCCTCCT -> TCTTGCATTACCCCTCCTA
ACTTGGTTAGTGACCTTAC -> CTTGGTTAGTGACCTTACC
AGCAGATAACCGCACTAGG -> GCAGATAACCGCACTAGGA
GTGTAATGCATCAATTAGA -> TGTAATGCATCAATTAGAG
ACCTTTATAGCATAATTAG -> CCTTTATAGCATAATTAGG
ATAGCATAATTAGGCGCTC -> TAGCATAATTAGGCGCTCA
CGCGCCGTGCGGTCACATT -> GCGCCGTGCGGTCACATTT
TTTACACCCTCTAAGCGTA -> TTACACCCTCTAAGCGTAT
CTCCACGTCCTCTTGTGGA -> TCCACGTCCTCTTGTGGAG
TTAATCCTTACACGAATAT -> TAATCCTTACACGAATATA
TACCTCGACATCTGGCGCG -> ACCTCGACATCTGGCGCGG
ACCAGGTGGCTTTAGAGCT -> CCAGGTGGCTTTAGAGCTA
CGATGCAATGCCTTCGATG -> GATGCAATGCCTTCGATGG
CGCTCATACCGTACATAAC -> GCTCATACCGTACATAACA
TGCCCTGCTTGGGTGTATA -> GCCCTGCTTGGGTGTATAA
ATGAGACCTTGATTCGTAC -> TGAGACCTTGATTCGTACG
GCTGGCGATTTAATTGTAT -> CTGGCGATTTAATTGTATG
TGTCGGCTGCGACTTGCCC -> GTCGGCTGCGACTTGCCCT
AGGCGCTTGTCTTGCCGGC -> GGCGCTTGTCTTGCCGGCC
GATCCTGGACAGCACGTCA -> ATCCTGGACAGCACGTCAC
GGCTGGCGATTTAATTGTA -> GCTGGCGATTTAATTGTAT
ATGACCCGTAGGCGCTTGT -> TGACCCGTAGGCGCTTGTC
TGCTCATCCAAGCGCGCGC -> GCTCATCCAAGCGCGCGCC
ACCCTCTAAGCGTATTTGG -> CCCTCTAAGCGTATTTGGC
GAAACGGTTCAACTTGGAC -> AAACGGTTCAACTTGGACC
CTTGGCAAGCAAGATCGCA -> TTGGCAAGCAAGATCGCAC
GTCTTGAGCCGCCGTAGGC -> TCTTGAGCCGCCGTAGGCG
AAGCATCTCATTTTCGTCC -> AGCATCTCATTTTCGTCCA
GTAATGCCCTCCGAATTTG -> TAATGCCCTCCGAATTTGG
ATCTTGGCAAGCAAGATCG -> TCTTGGCAAGCAAGATCGC
TGGTCATTCCTGGCCCTCG -> GGTCATTCCTGGCCCTCGC
ACCCTGATGTTGGATCCTT -> CCCTGATGTTGGATCCTTG
TGCATATCTTTAAACTGGA -> GCATATCTTTAAACTGGAC
CACGAGGTCGATAGCAAGA -> ACGAGGTCGATAGCAAGAA
GGTCGATAGCAAGAAACTT -> GTCGATAGCAAGAAACTTG
TGCCTTCGATGGCGGACCA -> GCCTTCGATGGCGGACCAC
TTACGCGGGTCTGCAGTGT -> TACGCGGGTCTGCAGTGTC
TGGTTAGCACCTCCATGAC -> GGTTAGCACCTCCATGACC
ACCGGTTACGCGGGTCTGC -> CCGGTTACGCGGGTCTGCA
GTATTCAACAATGTACGGG -> TATTCAACAATGTACGGGC
ATATCCGTAGGCGCTTGTC -> TATCCGTAGGCGCTTGTCT
CGTCCACTTGCTCATCCAA -> GTCCACTTGCTCATCCAAG
CCATAGGTAATCCGGTGAT -> CATAGGTAATCCGGTGATA
TACGCGGGTCTGCAGTGTC -> ACGCGGGTCTGCAGTGTCC
CGAACTGCGTGCGTACTCT -> GAACTGCGTGCGTACTCTG
GGGCTTCCTGGCACAGGAA -> GGCTTCCTGGCACAGGAAC
ATAGGTAATCCGGTGATAG -> TAGGTAATCCGGTGATAGG
TTGTAATGCCCTCCGAATT -> TGTAATGCCCTCCGAATTT
AAGTTCGATGCAATGCCTT -> AGTTCGATGCAATGCCTTC
TGTAATGCCCTCCGAATTT -> GTAATGCCCTCCGAATTTG
AGCACGTCACGTAGTCACG -> GCACGTCACGTAGTCACGA
AAATACCCTCATCCAATGC -> AATACCCTCATCCAATGCC
GGCTCCACGTCCTCTTGTG -> GCTCCACGTCCTCTTGTGG
CTAAGCGTATTTGGCCAAC -> TAAGCGTATTTGGCCAACG
GTACATATCCTATCCTCAG -> TACATATCCTATCCTCAGC
TAATTTATGTGGACAGTCG -> AATTTATGTGGACAGTCGT
GCTACACCGACGTGAGGGT -> CTACACCGACGTGAGGGTA
CAGGTGGCTTTAGAGCTAA -> AGGTGGCTTTAGAGCTAAG
GCAATTGAGCGTCACTTAA -> CAATTGAGCGTCACTTAAA
TCCACTTGCTCATCCAAGC -> CCACTTGCTCATCCAAGCG
GCTTGTCTTGGACACGGCC -> CTTGTCTTGGACACGGCCA
TAGTCTTCAGGCTGGGTCG -> AGTCTTCAGGCTGGGTCGG
AGGCCATAGGTAATCCGGT -> GGCCATAGGTAATCCGGTG
GATCACAATCACCGTCTGG -> ATCACAATCACCGTCTGGC
ATCCTGGCACAGGAACTAA -> TCCTGGCACAGGAACTAAG
GGCCAGTCCTGGCACAGGA -> GCCAGTCCTGGCACAGGAA
CGTACATATCCTATCCTCA -> GTACATATCCTATCCTCAG
ATCTTGCCGCGCCGTGCGG -> TCTTGCCGCGCCGTGCGGT
GCCGTAGGCGCTTGTCTTG -> CCGTAGGCGCTTGTCTTGG
TGGGGGAGCAACTTAAATT -> GGGGGAGCAACTTAAATTC
AGTCGTCCAGATCCCTGCA -> GTCGTCCAGATCCCTGCAA
TAAGGGCTGGCGATTTAAT -> AAGGGCTGGCGATTTAATT
GATCTTGGCAAGCAAGATC -> ATCTTGGCAAGCAAGATCG
TGGCGCGGGTAAGTTCGAT -> GGCGCGGGTAAGTTCGATG
TCTTGTGAGCGTGACGTCC -> CTTGTGAGCGTGACGTCCT
CAGGCTGGGTCGGGTTCCG -> AGGCTGGGTCGGGTTCCGG
AAAGGAGTTTATCCTGTGG -> AAGGAGTTTATCCTGTGGG
CATTGCCCCTCGATGCAAG -> ATTGCCCCTCGATGCAAGT
ACATATGTGCATAGCATGT -> CATATGTGCATAGCATGTC
CACGCCGACGAATACCGAA -> ACGCCGACGAATACCGAAA
TTCGATGGCGGACCACCTA -> TCGATGGCGGACCACCTAG
GGGAGCAACTTAAATTCGC -> GGAGCAACTTAAATTCGCC
TGCCAGCAGGTGTTACACA -> GCCAGCAGGTGTTACACAC
GACTGACGCCGCTCAGGCC -> ACTGACGCCGCTCAGGCCA
CGTATGGCTCTGCGTATAG -> GTATGGCTCTGCGTATAGA
GTACTCAGGCCGTGTAATG -> TACTCAGGCCGTGTAATGC
GTGCGTACTCTGTCTCTTA -> TGCGTACTCTGTCTCTTAT
GGTCCAAATACCCTCATCC -> GTCCAAATACCCTCATCCA
CTGGCGATTTAATTGTATG -> TGGCGATTTAATTGTATGC
CACAGGAACTAAGGAACCC -> ACAGGAACTAAGGAACCCT
GGGTGTATAATTTATGTGG -> GGTGTATAATTTATGTGGA
GTATGCCCTATCATGAGAC -> TATGCCCTATCATGAGACC
ACAGGCAACCGTAGGCGCT -> CAGGCAACCGTAGGCGCTT
TCGATGCAATGCCTTCGAT -> CGATGCAATGCCTTCGATG
CACACCGACCTGGGACTGA -> ACACCGACCTGGGACTGAC
TTCTGCCCCACATTGCCCT -> TCTGCCCCACATTGCCCTT
CCACTTGGCCAGGGACAGT -> CACTTGGCCAGGGACAGTT
TTGATGGTTTAGGTGCAAC -> TGATGGTTTAGGTGCAACC
ATTATCCTGGCATCTTCCG -> TTATCCTGGCATCTTCCGA
GCCAGGGACAGTTAGCCGC -> CCAGGGACAGTTAGCCGCG
CCAGATCCCTGCAACATAT -> CAGATCCCTGCAACATATG
GTCTTGGACACGGCCAGTC -> TCTTGGACACGGCCAGTCC
AGGCGCTTGTCTTGTGAGC -> GGCGCTTGTCTTGTGAGCG
CGGCTCCACGTCCTCTTGT -> GGCTCCACGTCCTCTTGTG
CCCCGGTGCCAGCAGGTGT -> CCCGGTGCCAGCAGGTGTT
TTGGCCAGGGACAGTTAGC -> TGGCCAGGGACAGTTAGCC
ATCCTGGACAGCACGTCAC -> TCCTGGACAGCACGTCACG
TGGCCGTACATATCCTATC -> GGCCGTACATATCCTATCC
TATACCGGTTACGCGGGTC -> ATACCGGTTACGCGGGTCT
GTAACATTAGTAATGGAAG -> TAACATTAGTAATGGAAGT
TCAGAGCTGGGGGAGCAAC -> CAGAGCTGGGGGAGCAACT
ACTCGTCCAACCGCACGCC -> CTCGTCCAACCGCACGCCG
ATCCTGTGGGCAGTTCCTG -> TCCTGTGGGCAGTTCCTGG
ACGACAATCAAAGCCCGAC -> CGACAATCAAAGCCCGACC
CAGTTAGCCGCGTAACATT -> AGTTAGCCGCGTAACATTA
ATGTGCATAGCATGTCCAG -> TGTGCATAGCATGTCCAGT
GATAGGATCCCCGAAACGT -> ATAGGATCCCCGAAACGTA
GGTTCAACTTGGACCACTT -> GTTCAACTTGGACCACTTG
AAGCGCGCGCCCATTACCG -> AGCGCGCGCCCATTACCGC
TGATGGTTTAGGTGCAACC -> GATGGTTTAGGTGCAACCG
TTTACCTCGACATCTGGCG -> TTACCTCGACATCTGGCGC
TCCAGATCCCTGCAACATA -> CCAGATCCCTGCAACATAT
CGTCCTCTTGTGGAGAGCG -> GTCCTCTTGTGGAGAGCGG
AGTAATGGAAGTATCTGTG -> GTAATGGAAGTATCTGTGC
GCCGCGCCGTGCGGTCACA -> CCGCGCCGTGCGGTCACAT
GTGCACACCAAGACCCCCG -> TGCACACCAAGACCCCCGG
TATGCCCTATCATGAGACC -> ATGCCCTATCATGAGACCT
TCATGAGACCTTGATTCGT -> CATGAGACCTTGATTCGTA
CCAAGTTCGGGACTGTGTA -> CAAGTTCGGGACTGTGTAG
GACTAAGGGCTGGCGATTT -> ACTAAGGGCTGGCGATTTA
GAGACGTCGTTGGTTAGCA -> AGACGTCGTTGGTTAGCAC
GCCAGCAGGTGTTACACAC -> CCAGCAGGTGTTACACACC
TCGTCCACTTGCTCATCCA -> CGTCCACTTGCTCATCCAA
GTCACGAGGTCGATAGCAA -> TCACGAGGTCGATAGCAAG
GCTCATACCGTACATAACA -> CTCATACCGTACATAACAT
TCCTATCCTCAGCGCGTCC -> CCTATCCTCAGCGCGTCCG
TCTGACTACATAGGGTAGA -> CTGACTACATAGGGTAGAT
AGACTAGTCTTCAGGCTGG -> GACTAGTCTTCAGGCTGGG
GCCCTCGCAAGAAAGACTC -> CCCTCGCAAGAAAGACTCG
CTGTGGCAAGGATCACAAT -> TGTGGCAAGGATCACAATC
AATCAAAGCCCGACCTACA -> ATCAAAGCCCGACCTACAC
TAGCACCTCCATGACCCGT -> AGCACCTCCATGACCCGTA
GAAACAAGACTAGTCTTCA -> AAACAAGACTAGTCTTCAG
TCTTAGAGCGCCGACAGGC -> CTTAGAGCGCCGACAGGCA
TGTACGGGCCAGCAGATAA -> GTACGGGCCAGCAGATAAC
CACCCCAAATTATCCTGGC -> ACCCCAAATTATCCTGGCA
GACCCTGATGTTGGATCCT -> ACCCTGATGTTGGATCCTT
GGATCACAATCACCGTCTG -> GATCACAATCACCGTCTGG
AAGAAACTTGGTTAGTGAC -> AGAAACTTGGTTAGTGACC
AAGGATCACAATCACCGTC -> AGGATCACAATCACCGTCT
AACCGCACTAGGACAGCTC -> ACCGCACTAGGACAGCTCG
TTATACCTCGGCGGTCCAA -> TATACCTCGGCGGTCCAAA
GAACTAAGGTTATACCTCG -> AACTAAGGTTATACCTCGG
AATATAGATTCATGGTCCT -> ATATAGATTCATGGTCCTT
ACACCGCGGGCCTGATGGT -> CACCGCGGGCCTGATGGTG
GGTTTGATGGTTTAGGTGC -> GTTTGATGGTTTAGGTGCA
ACGCCCGCCCCGGTGCCAG -> CGCCCGCCCCGGTGCCAGC
TGCAAGTACTGTGGCAAGG -> GCAAGTACTGTGGCAAGGA
GTAGCCTTGATCATGGTGC -> TAGCCTTGATCATGGTGCT
TCTCGAAACGGTTCAACTT -> CTCGAAACGGTTCAACTTG
TCTTGGCAAGCAAGATCGC -> CTTGGCAAGCAAGATCGCA
TGCATAGCATGTCCAGTGT -> GCATAGCATGTCCAGTGTA
TGGCACAGGAACTAAGGGA -> GGCACAGGAACTAAGGGAG
CTACACACCGTTGGTGTCT -> TACACACCGTTGGTGTCTG
CGTACGCAATTGAGCGTCA -> GTACGCAATTGAGCGTCAC
CCTGTACTCAGGCCGTGTA -> CTGTACTCAGGCCGTGTAA
TGTTGGATCCTTGCGAACT -> GTTGGATCCTTGCGAACTG
CAATGTACGGGCCAGCAGA -> AATGTACGGGCCAGCAGAT
AGATACTCAGAGACGTCGT -> GATACTCAGAGACGTCGTT
GGTAATCCGGTGATAGGAT -> GTAATCCGGTGATAGGATC
ATAGGGTAGATCCTGGACA -> TAGGGTAGATCCTGGACAG
TAGCCGCGTAACATTAGTA -> AGCCGCGTAACATTAGTAA
CAGTCTAGTGGCTGCACGC -> AGTCTAGTGGCTGCACGCT
TGGCAAGCAAGATCGCACC -> GGCAAGCAAGATCGCACCA
TCATTCCTGGCCCTCGCAA -> CATTCCTGGCCCTCGCAAG
TGATCATGGTGCTAGGAAA -> GATCATGGTGCTAGGAAAT
ATTTGGCCAACGACAATCA -> TTTGGCCAACGACAATCAA
ACCGCACTAGGACAGCTCG -> CCGCACTAGGACAGCTCGA
CATTGCCCTTGTAATGCCC -> ATTGCCCTTGTAATGCCCT
ATGCCCTATCATGAGACCT -> TGCCCTATCATGAGACCTT
GCTAGCGTGTCGGCTGCGA -> CTAGCGTGTCGGCTGCGAC
AGCACCTCCATGACCCGTA -> GCACCTCCATGACCCGTAG
CAGACGGACTGCCCTGCTT -> AGACGGACTGCCCTGCTTG
CGCCAGTCTAGTGGCTGCA -> GCCAGTCTAGTGGCTGCAC
AGCAGGTGTTACACACCGA -> GCAGGTGTTACACACCGAC
GTGGCAAGGATCACAATCA -> TGGCAAGGATCACAATCAC
CCTTGATTCGTACGGCATG -> CTTGATTCGTACGGCATGT
TCCAAGCGCGCGCCCATTA -> CCAAGCGCGCGCCCATTAC
ATGGCTCTGCGTATAGAAC -> TGGCTCTGCGTATAGAACG
CCTGTGGGCAGTTCCTGGC -> CTGTGGGCAGTTCCTGGCG
ATTCGTGTCTGGCTTAATC -> TTCGTGTCTGGCTTAATCT
AGCGTGACGTCCTGGCACA -> GCGTGACGTCCTGGCACAG
TGACCCTTATCTTGCCGCG -> GACCCTTATCTTGCCGCGC
CTGTACTCAGGCCGTGTAA -> TGTACTCAGGCCGTGTAAT
GCTTCCTGGCACAGGAACT -> CTTCCTGGCACAGGAACTA
AATACCCTCATCCAATGCC -> ATACCCTCATCCAATGCCG
GAGCAACTTAAATTCGCCC -> AGCAACTTAAATTCGCCCA
TCCACGTCCTCTTGTGGAG -> CCACGTCCTCTTGTGGAGA
TGGCTCTGCGTATAGAACG -> GGCTCTGCGTATAGAACGG
CCTTGCGAACTGCGTGCGT -> CTTGCGAACTGCGTGCGTA
CCACATTGCCCTTGTAATG -> CACATTGCCCTTGTAATGC
ACCGTAGGAAGCCAAGTTC -> CCGTAGGAAGCCAAGTTCG
ATCAATTAGAGGTGCATAT -> TCAATTAGAGGTGCATATC
CTCGACATCTGGCGCGGGT -> TCGACATCTGGCGCGGGTA
GCGCTTGTCTTGAGCCGCC -> CGCTTGTCTTGAGCCGCCG
GCGCTTGTCTTGCCGGCCG -> CGCTTGTCTTGCCGGCCGT
CTTGGGTGTATAATTTATG -> TTGGGTGTATAATTTATGT
AGGCTGGGTCGGGTTCCGG -> GGCTGGGTCGGGTTCCGGC
TACTCAGGCCGTGTAATGC -> ACTCAGGCCGTGTAATGCA
CGGGTTCCGGCGGTAGACC -> GGGTTCCGGCGGTAGACCT
AGCGTATTTGGCCAACGAC -> GCGTATTTGGCCAACGACA
GCTGGGTCGGGTTCCGGCG -> CTGGGTCGGGTTCCGGCGG
CTGGCATCTTCCGACGATC -> TGGCATCTTCCGACGATCT
CGAATTTGGACCACAGATC -> GAATTTGGACCACAGATCC
GAGCTGGGGGAGCAACTTA -> AGCTGGGGGAGCAACTTAA
CATCTGGCGCGGGTAAGTT -> ATCTGGCGCGGGTAAGTTC
CCTTACACGAATATAGATT -> CTTACACGAATATAGATTC
CCAGGTGGCTTTAGAGCTA -> CAGGTGGCTTTAGAGCTAA
GCCCAAAGATGGTCATTCC -> CCCAAAGATGGTCATTCCT
TGGATCCTTGCGAACTGCG -> GGATCCTTGCGAACTGCGT
TCTGTCTCTTATTTGCCCA -> CTGTCTCTTATTTGCCCAT
TATCCTGTGGGCAGTTCCT -> ATCCTGTGGGCAGTTCCTG
ATTCTGCCCCACATTGCCC -> TTCTGCCCCACATTGCCCT
CGCACTAGGACAGCTCGAC -> GCACTAGGACAGCTCGACG
GTCTCTTATTTGCCCATGG -> TCTCTTATTTGCCCATGGT
CGCGGGTCTGCAGTGTCCT -> GCGGGTCTGCAGTGTCCTC
GTCTTGTGAGCGTGACGTC -> TCTTGTGAGCGTGACGTCC
GGTGCACACCAAGACCCCC -> GTGCACACCAAGACCCCCG
GCACCAGGTGGCTTTAGAG -> CACCAGGTGGCTTTAGAGC
TGATAGGATCCCCGAAACG -> GATAGGATCCCCGAAACGT
ATACTCAGAGCTGGGGGAG -> TACTCAGAGCTGGGGGAGC
AGTAGATCTTGGCAAGCAA -> GTAGATCTTGGCAAGCAAG
ATTAGTCTTAAGTCGTCCA -> TTAGTCTTAAGTCGTCCAG
GTAGACCTAAATGGAACTG -> TAGACCTAAATGGAACTGT
AGCGGGGCTTCCTGGCACA -> GCGGGGCTTCCTGGCACAG
GCCAGTCCTGGCACAGGAA -> CCAGTCCTGGCACAGGAAC
TCCTTCTATATCCGTAGGC -> CCTTCTATATCCGTAGGCG
ACTGCACTTTACCTCGACA -> CTGCACTTTACCTCGACAT
CAAGACTAGTCTTCAGGCT -> AAGACTAGTCTTCAGGCTG
GCGTACTCTGTCTCTTATT -> CGTACTCTGTCTCTTATTT
CTCTGACTACATAGGGTAG -> TCTGACTACATAGGGTAGA
TGACGCCGCTCAGGCCATA -> GACGCCGCTCAGGCCATAG
CGCCGACGAATACCGAAAG -> GCCGACGAATACCGAAAGG
AAATCACGTAGCCTTGATC -> AATCACGTAGCCTTGATCA
GAAAGGAGTTTATCCTGTG -> AAAGGAGTTTATCCTGTGG
TCGCTCCAGGACTAAGGGC -> CGCTCCAGGACTAAGGGCT
ACATCTGGCGCGGGTAAGT -> CATCTGGCGCGGGTAAGTT
AGCGGCGATTCGTGTCTGG -> GCGGCGATTCGTGTCTGGC
CTCATTTTCGTCCACTTGC -> TCATTTTCGTCCACTTGCT
GCCGTGCGGTCACATTTTT -> CCGTGCGGTCACATTTTTC
TTGCCCTTGTAATGCCCTC -> TGCCCTTGTAATGCCCTCC
ATTCACCAGCGAAATCACG -> TTCACCAGCGAAATCACGT
ACAGGAACTAAGGAACCCT -> CAGGAACTAAGGAACCCTT
AAATATACGAAACAAGACT -> AATATACGAAACAAGACTA
GCGCGCGCCCATTACCGCT -> CGCGCGCCCATTACCGCTT
GCCAAGCATCTCATTTTCG -> CCAAGCATCTCATTTTCGT
GACGTGAGGGTATCGGCTC -> ACGTGAGGGTATCGGCTCC
TCAATTAGAGGTGCATATC -> CAATTAGAGGTGCATATCT
GAGCGTGACGTCCTGGCAC -> AGCGTGACGTCCTGGCACA
TAGGTTTGATGGTTTAGGT -> AGGTTTGATGGTTTAGGTG
GTACTCTGTCTCTTATTTG -> TACTCTGTCTCTTATTTGC
TCATCCAATGCCGCCAAGC -> CATCCAATGCCGCCAAGCA
AGCAAGAAACTTGGTTAGT -> GCAAGAAACTTGGTTAGTG
TCCCGACACCGCGGGCCTG -> CCCGACACCGCGGGCCTGA
GACCTTGATTCGTACGGCA -> ACCTTGATTCGTACGGCAT
GCAACTGCACTTTACCTCG -> CAACTGCACTTTACCTCGA
TATACGAAACAAGACTAGT -> ATACGAAACAAGACTAGTC
TTTATCCTGTGGGCAGTTC -> TTATCCTGTGGGCAGTTCC
GCACGCTACACCGACGTGA -> CACGCTACACCGACGTGAG
CCGACACCGCGGGCCTGAT -> CGACACCGCGGGCCTGATG
TGCCGCGCCGTGCGGTCAC -> GCCGCGCCGTGCGGTCACA
TAATGGAAGTATCTGTGCA -> AATGGAAGTATCTGTGCAC
CAGTGTCCTCTGACTACAT -> AGTGTCCTCTGACTACATA
CTAAAGAACCGACCCTGAT -> TAAAGAACCGACCCTGATG
CGTTGAATGGTTTTAAGCC -> GTTGAATGGTTTTAAGCCG
GATCCCTGCAACATATGTG -> ATCCCTGCAACATATGTGC
TCACAATCACCGTCTGGCC -> CACAATCACCGTCTGGCCC
TGACCTTACCGCTGCGATG -> GACCTTACCGCTGCGATGG
CTACACCGACGTGAGGGTA -> TACACCGACGTGAGGGTAT
CCCTGCAACATATGTGCAT -> CCTGCAACATATGTGCATA
GAAGTATCTGTGCACAAAT -> AAGTATCTGTGCACAAATT
TATCATGAGACCTTGATTC -> ATCATGAGACCTTGATTCG
TTGAGCGTCACTTAAACAC -> TGAGCGTCACTTAAACACC
TCAACTTGGACCACTTGGC -> CAACTTGGACCACTTGGCC
GGCTGGGTCGGGTTCCGGC -> GCTGGGTCGGGTTCCGGCG
TCTTTTGCAACTGCACTTT -> CTTTTGCAACTGCACTTTA
TCCGGTGATAGGATCCCCG -> CCGGTGATAGGATCCCCGA
CCGCTCAGGCCATAGGTAA -> CGCTCAGGCCATAGGTAAT
CCCTGCTTGGGTGTATAAT -> CCTGCTTGGGTGTATAATT
GGTAGACCTAAATGGAACT -> GTAGACCTAAATGGAACTG
CTTGCCCTGCGGCACCGAC -> TTGCCCTGCGGCACCGACC
ACCCCTCCTATTAGTCTTA -> CCCCTCCTATTAGTCTTAA
GAACAAAGGGACGCGCCAG -> AACAAAGGGACGCGCCAGT
AGTCACGAGGTCGATAGCA -> GTCACGAGGTCGATAGCAA
GAAAGACTCGTCCAACCGC -> AAAGACTCGTCCAACCGCA
GCGGTCACATTTTTCCTGT -> CGGTCACATTTTTCCTGTA
TTTGGACCACAGATCCATG -> TTGGACCACAGATCCATGA
TAGGATCCCCGAAACGTAT -> AGGATCCCCGAAACGTATG
CTAAGGGAGAACAAAGGGA -> TAAGGGAGAACAAAGGGAC
CAAATTATCCTGGCATCTT -> AAATTATCCTGGCATCTTC
CTTGCCGGCCGTTAATCCT -> TTGCCGGCCGTTAATCCTG
GGCGGTCCAAATACCCTCA -> GCGGTCCAAATACCCTCAT
GATCATGGTGCTAGGAAAT -> ATCATGGTGCTAGGAAATA
GGGTATCGGCTCCACGTCC -> GGTATCGGCTCCACGTCCT
GAACGGCGTTGAATGGTTT -> AACGGCGTTGAATGGTTTT
AGCTAAGTAGATACTCAGA -> GCTAAGTAGATACTCAGAG
TAGGTGTCCAATTCAACAG -> AGGTGTCCAATTCAACAGA
CTCTTGTGGAGAGCGGCGA -> TCTTGTGGAGAGCGGCGAT
CGAAAGGAGTTTATCCTGT -> GAAAGGAGTTTATCCTGTG
GTTAATCCTGGCACAGGAA -> TTAATCCTGGCACAGGAAC
TGAATGAAGACGCCCGCCC -> GAATGAAGACGCCCGCCCC
TCATACCGTACATAACATA -> CATACCGTACATAACATAG
CGGTGATAGGATCCCCGAA -> GGTGATAGGATCCCCGAAA
AGCGTCACTTAAACACCCC -> GCGTCACTTAAACACCCCA
CCTCTGACTACATAGGGTA -> CTCTGACTACATAGGGTAG
CCGAGGTGTATTCAACAAT -> CGAGGTGTATTCAACAATG
CCGTAGGCGCTTGTCTTGC -> CGTAGGCGCTTGTCTTGCC
CATATGTGCATAGCATGTC -> ATATGTGCATAGCATGTCC
GACCCTTATCTTGCCGCGC -> ACCCTTATCTTGCCGCGCC
CACCTAGAACCACCCATTG -> ACCTAGAACCACCCATTGC
TTCGGGACTGTGTAGGCTA -> TCGGGACTGTGTAGGCTAT
GCATCAATTAGAGGTGCAT -> CATCAATTAGAGGTGCATA
ATGGCGGACCACCTAGAAC -> TGGCGGACCACCTAGAACC
CTTATCTTGCCGCGCCGTG -> TTATCTTGCCGCGCCGTGC
CACCGTTGGTGTCTGATAC -> ACCGTTGGTGTCTGATACT
CAAGCATCTCATTTTCGTC -> AAGCATCTCATTTTCGTCC
CAGGAACTAAGCGGGGCTT -> AGGAACTAAGCGGGGCTTC
TATATCCGTAGGCGCTTGT -> ATATCCGTAGGCGCTTGTC
TAAGGAACCCTTCTTAACG -> AAGGAACCCTTCTTAACGT
GTTCGATGCAATGCCTTCG -> TTCGATGCAATGCCTTCGA
TCAACAATGTACGGGCCAG -> CAACAATGTACGGGCCAGC
AGGTGTCCAATTCAACAGA -> GGTGTCCAATTCAACAGAC
CATAGGGTAGATCCTGGAC -> ATAGGGTAGATCCTGGACA
AATGCATCAATTAGAGGTG -> ATGCATCAATTAGAGGTGC
TAATCTTAGAGCGCCGACA -> AATCTTAGAGCGCCGACAG
TAGGCGCTCATACCGTACA -> AGGCGCTCATACCGTACAT
TATCTTGCCGCGCCGTGCG -> ATCTTGCCGCGCCGTGCGG
CCCCCGGCACCGTACGCAA -> CCCCGGCACCGTACGCAAT
AAGCGGGGCTTCCTGGCAC -> AGCGGGGCTTCCTGGCACA
ACATAGGGTAGATCCTGGA -> CATAGGGTAGATCCTGGAC
TGTCTTGAGCCGCCGTAGG -> GTCTTGAGCCGCCGTAGGC
AACTAAGGGAGAACAAAGG -> ACTAAGGGAGAACAAAGGG
CGCCGTGCGGTCACATTTT -> GCCGTGCGGTCACATTTTT
GCTGCACGCTACACCGACG -> CTGCACGCTACACCGACGT
TAGATCTTGGCAAGCAAGA -> AGATCTTGGCAAGCAAGAT
GTGTATAATTTATGTGGAC -> TGTATAATTTATGTGGACA
GATACTCAGAGCTGGGGGA -> ATACTCAGAGCTGGGGGAG
TGCTAGGAAATAGCCCTGA -> GCTAGGAAATAGCCCTGAC
GACTAGTCTTCAGGCTGGG -> ACTAGTCTTCAGGCTGGGT
TGACTACATAGGGTAGATC -> GACTACATAGGGTAGATCC
AAACGGTTCAACTTGGACC -> AACGGTTCAACTTGGACCA
AATGCCCTCCGAATTTGGA -> ATGCCCTCCGAATTTGGAC
TATTCTGCCCCACATTGCC -> ATTCTGCCCCACATTGCCC
ATCGCACCAGGTGGCTTTA -> TCGCACCAGGTGGCTTTAG
CTCGGAGTAGATCTTGGCA -> TCGGAGTAGATCTTGGCAA
GACCCCCGGCACCGTACGC -> ACCCCCGGCACCGTACGCA
TCCGAATTTGGACCACAGA -> CCGAATTTGGACCACAGAT
ACGTCCTCTTGTGGAGAGC -> CGTCCTCTTGTGGAGAGCG
GCTAAGTAGATACTCAGAG -> CTAAGTAGATACTCAGAGA
GTTCCGGCGGTAGACCTAA -> TTCCGGCGGTAGACCTAAA
AAAGGGACGCGCCAGTCTA -> AAGGGACGCGCCAGTCTAG
TGGGCAGTTCCTGGCGAAA -> GGGCAGTTCCTGGCGAAAT
GTCCGTCGACTATACCGGT -> TCCGTCGACTATACCGGTT
TGTTACACACCGACCTGGG -> GTTACACACCGACCTGGGA
TAAATTCGCCCAAAGATGG -> AAATTCGCCCAAAGATGGT
ACCACCTAGAACCACCCAT -> CCACCTAGAACCACCCATT
AACTTGGTTAGTGACCTTA -> ACTTGGTTAGTGACCTTAC
GTGCACAAATTTACACCCT -> TGCACAAATTTACACCCTC
GTCACATTTTTCCTGTACT -> TCACATTTTTCCTGTACTC
AGGAACTAAGCGGGGCTTC -> GGAACTAAGCGGGGCTTCC
ATAGGTTTGATGGTTTAGG -> TAGGTTTGATGGTTTAGGT
TCGAAACGGTTCAACTTGG -> CGAAACGGTTCAACTTGGA
CTCTCGGAGTAGATCTTGG -> TCTCGGAGTAGATCTTGGC
TCTCTCGAAACGGTTCAAC -> CTCTCGAAACGGTTCAACT
GGCGCGGGTAAGTTCGATG -> GCGCGGGTAAGTTCGATGC
GGAACTAAGCGGGGCTTCC -> GAACTAAGCGGGGCTTCCT
CGCGCGCCCATTACCGCTT -> GCGCGCCCATTACCGCTTT
GCGGGCCTGATGGTGCACA -> CGGGCCTGATGGTGCACAC
TTCGGTCTAAAGAACCGAC -> TCGGTCTAAAGAACCGACC
AATGGAACTGTCATTCACC -> ATGGAACTGTCATTCACCA
TTTAAACTGGACAAGCCTC -> TTAAACTGGACAAGCCTCT
CCGTCGACTATACCGGTTA -> CGTCGACTATACCGGTTAC
CAATTAGAGGTGCATATCT -> AATTAGAGGTGCATATCTT
CCGAGGTCGCTCCAGGACT -> CGAGGTCGCTCCAGGACTA
CCAGCAGATAACCGCACTA -> CAGCAGATAACCGCACTAG
TACCCCTCCTATTAGTCTT -> ACCCCTCCTATTAGTCTTA
ATTAGTAATGGAAGTATCT -> TTAGTAATGGAAGTATCTG
TCCTGGCACAGGAACTAAG -> CCTGGCACAGGAACTAAGG, CCTGGCACAGGAACTAAGG, CCTGGCACAGGAACTAAGC, CCTGGCACAGGAACTAAGG
TTAAACACCCCAAATTATC -> TAAACACCCCAAATTATCC
GTAATGCATCAATTAGAGG -> TAATGCATCAATTAGAGGT
CCCGCCCCGGTGCCAGCAG -> CCGCCCCGGTGCCAGCAGG
AATTCGCCCAAAGATGGTC -> ATTCGCCCAAAGATGGTCA
GTCTGGCTTAATCTTAGAG -> TCTGGCTTAATCTTAGAGC
GGCAGTTCCTGGCGAAATA -> GCAGTTCCTGGCGAAATAT
CGCGTCCGTCGACTATACC -> GCGTCCGTCGACTATACCG
GGCTTAATCTTAGAGCGCC -> GCTTAATCTTAGAGCGCCG
ACCGTAGGCGCTTGTCTTG -> CCGTAGGCGCTTGTCTTGA
CGTTAATCCTGGCACAGGA -> GTTAATCCTGGCACAGGAA
CGACCCTGATGTTGGATCC -> GACCCTGATGTTGGATCCT
TCCAAATACCCTCATCCAA -> CCAAATACCCTCATCCAAT
TCCTGGCCCTCGCAAGAAA -> CCTGGCCCTCGCAAGAAAG
ACATAGGTCACCTATTCGG -> CATAGGTCACCTATTCGGT
AGCCGAGGTCGCTCCAGGA -> GCCGAGGTCGCTCCAGGAC
TGTATGCCCTATCATGAGA -> GTATGCCCTATCATGAGAC
GAACTAAGGAACCCTTCTT -> AACTAAGGAACCCTTCTTA
ACCGTTGGTGTCTGATACT -> CCGTTGGTGTCTGATACTC
TCCTGGACAGCACGTCACG -> CCTGGACAGCACGTCACGT
GGCGCTCATACCGTACATA -> GCGCTCATACCGTACATAA
CGGGGCTTCCTGGCACAGG -> GGGGCTTCCTGGCACAGGA
TCGTGGCCGTACATATCCT -> CGTGGCCGTACATATCCTA
TCCATGACCCGTAGGCGCT -> CCATGACCCGTAGGCGCTT
CATAGGTCACCTATTCGGT -> ATAGGTCACCTATTCGGTC
GGGGGAGCAACTTAAATTC -> GGGGAGCAACTTAAATTCG
GAAATAGCCCTGACCCTTA -> AAATAGCCCTGACCCTTAT
GACAAGCCTCTCGGAGTAG -> ACAAGCCTCTCGGAGTAGA
ATACCGAAAGGAGTTTATC -> TACCGAAAGGAGTTTATCC
CACAGATCCATGAATGAAG -> ACAGATCCATGAATGAAGA
CCCCTCGATGCAAGTACTG -> CCCTCGATGCAAGTACTGT
CGCAATTGAGCGTCACTTA -> GCAATTGAGCGTCACTTAA
GTCTTAAGTCGTCCAGATC -> TCTTAAGTCGTCCAGATCC
TGGTGCACACCAAGACCCC -> GGTGCACACCAAGACCCCC
GTAGGCGCTTGTCTTGGAC -> TAGGCGCTTGTCTTGGACA

