TTGGTTGGTTC -> TGGTTGGTTCT
CGCGACCGTGT -> GCGACCGTGTA
TAGGGATACAG -> AGGGATACAGC
TAGATGGGTGA -> AGATGGGTGAT
CAAGGTGCTAC -> AAGGTGCTACA
ACCAGCGTTAT -> CCAGCGTTATC
TGGATGACTTG -> GGATGACTTGG
TTTATTACATT -> TTATTACATTA
CCTAAAGGTAT -> CTAAAGGTATC
TTGTTGGTGAC -> TGTTGGTGACC
TTTGTAATATA -> TTGTAATATAT
GTACATCCACT -> TACATCCACTC
GAAGGTTCCTA -> AAGGTTCCTAC
CAACTGGCATA -> AACTGGCATAG
AGGTTCATTAA -> GGTTCATTAAG
CGAACGTTTGC -> GAACGTTTGCT
CTCCTTGGGAC -> TCCTTGGGACA
CCGTGGCTTAA -> CGTGGCTTAAT
GATCCATCATC -> ATCCATCATCT
ATTATCCAACC -> TTATCCAACCT
CCTATAAGAAA -> CTATAAGAAAC
CCGCCACACTG -> CGCCACACTGA
CATTCTGCTAC -> ATTCTGCTACG
CTCCTCTTCCC -> TCCTCTTCCCG
GCAAATCTCTA -> CAAATCTCTAA
AAGGAGCCCGC -> AGGAGCCCGCC
ACAAGATGCTC -> CAAGATGCTCT
TGAATCCTTGT -> GAATCCTTGTT
CATTATACCGG -> ATTATACCGGG
GGGAAGGATGA -> GGAAGGATGAC
GCGGGTGAGCA -> CGGGTGAGCAA
GTGTGAACTGG -> TGTGAACTGGT
GCCCGGGACAT -> CCCGGGACATG
GTGATACGAAC -> TGATACGAACC
AGTTAATCCCA -> GTTAATCCCAA
TTATACGGTTG -> TATACGGTTGG
GGTTCTAGGCC -> GTTCTAGGCCC
CCTACGGGTGA -> CTACGGGTGAG
TGAGCACTATA -> GAGCACTATAA
CCCTGACCAAT -> CCTGACCAATC
AATCTACAAGC -> ATCTACAAGCG
CCTTACTCGAA -> CTTACTCGAAC
GTTACCGGCCA -> TTACCGGCCAG
AGGTATCTATC -> GGTATCTATCC
TCTGGCACCTT -> CTGGCACCTTG
GCCATTTCTGG -> CCATTTCTGGC
CCGGGACATGT -> CGGGACATGTG
TAATGAGCGAT -> AATGAGCGATC
GCGCCGTGGCT -> CGCCGTGGCTT
GCCAAAGATCA -> CCAAAGATCAA
AAGGTGCTACA -> AGGTGCTACAA
GGCTTCTGAGA -> GCTTCTGAGAA
GCTCCAGATAG -> CTCCAGATAGT
CCCGCAGGTCC -> CCGCAGGTCCG
GTAGATGTTGA -> TAGATGTTGAG
TTCCTACGGGT -> TCCTACGGGTG
TTTATTTACCA -> TTATTTACCAG
TCGTACCAGCG -> CGTACCAGCGT
AGAAACACTCT -> GAAACACTCTG
TACATTATACC -> ACATTATACCG
GCTCCGAGTCT -> CTCCGAGTCTC
GGACTCCGGCA -> GACTCCGGCAG
GTGGACCACCC -> TGGACCACCCA
TGGCTTTATTA -> GGCTTTATTAC
TGACCTTTGTA -> GACCTTTGTAA
CGGATGGCTTT -> GGATGGCTTTA
TTCTGTCGACG -> TCTGTCGACGT
TTCCCGCAGGT -> TCCCGCAGGTC
AATTCAGCAGC -> ATTCAGCAGCA
TGGTAGATGGG -> GGTAGATGGGT
TTATACCGGGT -> TATACCGGGTA
CGTACCCCCTC -> GTACCCCCTCG
AATCTCTAAGG -> ATCTCTAAGGG
ACTTGGCTTCT -> CTTGGCTTCTG
CCACTCAGCAA -> CACTCAGCAAT
AGGTTAAAGGA -> GGTTAAAGGAG
CGTATTGGCTC -> GTATTGGCTCC
GGGCTTGAGGC -> GGCTTGAGGCT
CGCACCTTAGC -> GCACCTTAGCT
TGCCTAAAGGT -> GCCTAAAGGTA
CGAGACCCGCA -> GAGACCCGCAC
CCCGCCTTCAC -> CCGCCTTCACA
TGGCTTCTGAG -> GGCTTCTGAGA
GACTATCATTT -> ACTATCATTTA
TGTTGTCCCAT -> GTTGTCCCATG
AATCACGACTA -> ATCACGACTAT
TAGGGGAGCTC -> AGGGGAGCTCT
CGCCACACTCA -> GCCACACTCAG
CTGTAGTGGGC -> TGTAGTGGGCA
GTGCGATCCAC -> TGCGATCCACG
CTTCTGAGAAA -> TTCTGAGAAAA
ACCGCCACACT -> CCGCCACACTC
TACAGGTGAAC -> ACAGGTGAACT
CGATACTCTCA -> GATACTCTCAA
CGGGCAAGACA -> GGGCAAGACAT
CAGCGATACTC -> AGCGATACTCT
CCTGACCAATC -> CTGACCAATCA
AACCCTGTAGA -> ACCCTGTAGAT
TCTACCTTTCC -> CTACCTTTCCT
CCAGCGTTATC -> CAGCGTTATCG
CTTGCGCGTTT -> TTGCGCGTTTT
TGTTGACGCAG -> GTTGACGCAGA
GATTATCCAAC -> ATTATCCAACC
TTTCTGGCACC -> TTCTGGCACCT
GACCTTAGCTC -> ACCTTAGCTCG
AAAGTGTCTCT -> AAGTGTCTCTA
CAATCAGGTTC -> AATCAGGTTCA
GCGCGCTAGTC -> CGCGCTAGTCT
CGCACCAGCAC -> GCACCAGCACC
TCGGTAATGAG -> CGGTAATGAGC
TGCGCCTTTGT -> GCGCCTTTGTA
GTCTCTGGCCC -> TCTCTGGCCCA
AAAAGGGCATA -> AAAGGGCATAC
CTGGATGTCCA -> TGGATGTCCAT
TGGAGGTGTAT -> GGAGGTGTATA
GTACAGGTGAA -> TACAGGTGAAC
GTCGACGTACA -> TCGACGTACAT
GACTCTAGAAC -> ACTCTAGAACG
AATATATCTCT -> ATATATCTCTT
AGAATCACGAC -> GAATCACGACT
GTAGTAATGGA -> TAGTAATGGAC
GATTTAATGTC -> ATTTAATGTCA
CCTGTAGATGT -> CTGTAGATGTT
ACCAGAGGGGC -> CCAGAGGGGCA
GAGGGGCGGTC -> AGGGGCGGTCC
CTTAGCTCGTG -> TTAGCTCGTGC
CCCCCTCGTTC -> CCCCTCGTTCG
ATCATCTGAAG -> TCATCTGAAGA
AGACCCGCACC -> GACCCGCACCA
AGGGCACTCGG -> GGGCACTCGGG
TCGGACTGGAT -> CGGACTGGATG
ATTCGGGCAAG -> TTCGGGCAAGA
TCGCGGATGGC -> CGCGGATGGCT
AACGGAGATTA -> ACGGAGATTAT
CGGACTCCGGC -> GGACTCCGGCA
GAATCCAAGTT -> AATCCAAGTTA
AGGGCATACTG -> GGGCATACTGA
AGCTCGCACTT -> GCTCGCACTTG
CGGGAAAAAAT -> GGGAAAAAATG
CGTGATTTCGA -> GTGATTTCGAG
ACGCACCTTAG -> CGCACCTTAGC
AAAACGGCCTC -> AAACGGCCTCA
GAAGGACGGTG -> AAGGACGGTGG
GGCGAAGGTTC -> GCGAAGGTTCC
GGCGGTTCCTT -> GCGGTTCCTTG
CAGGGATACTC -> AGGGATACTCT
AGACGTAATTG -> GACGTAATTGA
AAAATGGGGAA -> AAATGGGGAAG
AATTCGGGCAA -> ATTCGGGCAAG
TACCCCAACGG -> ACCCCAACGGA
GAAAAAGTCCA -> AAAAAGTCCAG
ACGGCCTCAGG -> CGGCCTCAGGC
CAGATAATGCC -> AGATAATGCCC
CTCGAACGTTT -> TCGAACGTTTG
AGGGGAATCTC -> GGGGAATCTCA
AATGTGTCGCC -> ATGTGTCGCCG
CTACGATATAC -> TACGATATACC
GGGAGGCATCC -> GGAGGCATCCA
TACCAGCGTTA -> ACCAGCGTTAT
TTGCGGCGCAG -> TGCGGCGCAGT
AGCTGTTGCCT -> GCTGTTGCCTA
TAGAAGGTGAT -> AGAAGGTGATA
TGTCGACGTAC -> GTCGACGTACA
GTGCTCCAGAT -> TGCTCCAGATA
ACCCGCACCAG -> CCCGCACCAGC
GTGCTTTTCCA -> TGCTTTTCCAC
TGAGCGATCTG -> GAGCGATCTGC
ATCTATCCTAG -> TCTATCCTAGA
CACAAGATGCT -> ACAAGATGCTC
TGAGAAAAGTG -> GAGAAAAGTGT
GTGCAAATCTC -> TGCAAATCTCT
GGACCGTATTC -> GACCGTATTCC
GTTAAAGGAGC -> TTAAAGGAGCC
GAAGGCTGCGC -> AAGGCTGCGCG
ATGTCGGTAAG -> TGTCGGTAAGG
TGAACGGACCG -> GAACGGACCGT
TCTCGCACCGC -> CTCGCACCGCG
AGAGCACCAGA -> GAGCACCAGAC
CTCCGAGTCTC -> TCCGAGTCTCC
CCCTTGATGGT -> CCTTGATGGTA
AGGGATACAGC -> GGGATACAGCG
CACTCGGGAGG -> ACTCGGGAGGC
GACCGTATTCC -> ACCGTATTCCG
ACCCCCTCGTT -> CCCCCTCGTTC
CGCCGTGGCTT -> GCCGTGGCTTA
CCATTTCTGGC -> CATTTCTGGCA
AAGTTGCTCGC -> AGTTGCTCGCG
GACGACGTGAT -> ACGACGTGATT
CGCTTAATGCT -> GCTTAATGCTT
TAGGCCAAGAG -> AGGCCAAGAGG
ATCAGGCGCCG -> TCAGGCGCCGT
GCAGACATGGC -> CAGACATGGCA
GTTATACGGTT -> TTATACGGTTG
TGAATTCGGGC -> GAATTCGGGCA
GGCACCTTGGG -> GCACCTTGGGG
TACGCTTGTGT -> ACGCTTGTGTG
AGTAGAAACTG -> GTAGAAACTGA
AATGGGGAAGC -> ATGGGGAAGCA
AAAGTTGCTCG -> AAGTTGCTCGC
TTGCTCGCGGA -> TGCTCGCGGAT
ACGCCGGTGCT -> CGCCGGTGCTC
CAGATCCATCA -> AGATCCATCAT
GAGATTATCCA -> AGATTATCCAA
GCAGAGCACCA -> CAGAGCACCAG
AGCCCGCCTTC -> GCCCGCCTTCA
AGATGCTCTGT -> GATGCTCTGTG
GGACATCACGA -> GACATCACGAC
CGAAGGTTCCT -> GAAGGTTCCTA
GAACGGAGATT -> AACGGAGATTA
TTGGCTCCGAG -> TGGCTCCGAGT
GCAGAATCACG -> CAGAATCACGA
ACGCTCCTCTT -> CGCTCCTCTTC
GTCTCCTTGGG -> TCTCCTTGGGA
ATTCTTCGGGG -> TTCTTCGGGGG
GAAACTGAGTT -> AAACTGAGTTA
TGGAGTTACCG -> GGAGTTACCGG
GAACAGGGGTG -> AACAGGGGTGC
GGACGGTGGGC -> GACGGTGGGCT
GGTAAGGATGT -> GTAAGGATGTC
CCACGTGCATC -> CACGTGCATCC
CGCAAGGGCTT -> GCAAGGGCTTG
GTGTCCGAGAA -> TGTCCGAGAAT
GCAATCAGGTT -> CAATCAGGTTC
CTTACTCGAAC -> TTACTCGAACG
TTAAAAGGGCA -> TAAAAGGGCAT
AAGAAACACTC -> AGAAACACTCT
TATTTACCAGC -> ATTTACCAGCC
AGAAGGTGATA -> GAAGGTGATAC
TCCAGGAATAA -> CCAGGAATAAG
GCAGACCTTAG -> CAGACCTTAGC
GACGCCGGTGC -> ACGCCGGTGCT
CATGTGAACAG -> ATGTGAACAGG
GGACCGATATA -> GACCGATATAG
TGCTTTTCCAC -> GCTTTTCCACC
ATTTCGAGACC -> TTTCGAGACCC
TATAGTACCGG -> ATAGTACCGGA
TTCCACCGATC -> TCCACCGATCC
TATAATATACT -> ATAATATACTA
GCATTGGGACT -> CATTGGGACTT
AGCCGAGTCGG -> GCCGAGTCGGA
TTTGGCAGAAT -> TTGGCAGAATC
ACCCATAAAAC -> CCCATAAAACG
GCGACCGTGTA -> CGACCGTGTAT
GACCTTTGTAA -> ACCTTTGTAAT
AAACTCAGGCA -> AACTCAGGCAA
GTGAATCCTTG -> TGAATCCTTGT
AGAAAAAGTCC -> GAAAAAGTCCA
GGGGAAGCATT -> GGGAAGCATTG
CAGGCAAGGTG -> AGGCAAGGTGC
ATAAGAAACAC -> TAAGAAACACT
GCGCAGTAGGC -> CGCAGTAGGCC
AGGATGTCGGG -> GGATGTCGGGA
AGGGGCATTGG -> GGGGCATTGGG
CGTGGGTATAC -> GTGGGTATACG
TCGTGGGTATA -> CGTGGGTATAC
CAGACGTAATT -> AGACGTAATTG
ACACTGACACC -> CACTGACACCT
CTACCGTCATA -> TACCGTCATAG
AGCGATACTCT -> GCGATACTCTC
ACCTTAGCTCG -> CCTTAGCTCGT
TCCTAGAAGGT -> CCTAGAAGGTG
ATCTGGTAAGG -> TCTGGTAAGGG
TGAGTGTCCGA -> GAGTGTCCGAG
ATCTCTAAGGG -> TCTCTAAGGGC
ATGGCACGTGA -> TGGCACGTGAT
ACTTTAGGCGG -> CTTTAGGCGGG
ACATTCTGCTA -> CATTCTGCTAC
CGACCGTGTAT -> GACCGTGTATT
AGGGCTTGAGG -> GGGCTTGAGGC
CCGTGCTTTTC -> CGTGCTTTTCC
ATACGAACCCT -> TACGAACCCTG
TTGGCAACTCG -> TGGCAACTCGT
TCGCGGATGGT -> CGCGGATGGTA
GCATCCAGAGT -> CATCCAGAGTA
GGGGCATTGGG -> GGGCATTGGGA
GCTCGCACTTG -> CTCGCACTTGC
AACGGCCTCAG -> ACGGCCTCAGG
CAATGGCGAAG -> AATGGCGAAGG
GTTGGGACTTT -> TTGGGACTTTA
GCCCAGTAAAG -> CCCAGTAAAGG
TAAGTGCGTAG -> AAGTGCGTAGA
CACACTCAGGA -> ACACTCAGGAA
GACGTGTAGGG -> ACGTGTAGGGT
AGTAATGGACG -> GTAATGGACGC
ACGGTAAGGCC -> CGGTAAGGCCC
CAAGAGGGGCG -> AAGAGGGGCGG
CACCGCGGACG -> ACCGCGGACGC
GTCGGTAAGGA -> TCGGTAAGGAT
GGCAGAATCAC -> GCAGAATCACG
GAGCAATCGGA -> AGCAATCGGAG
TTCGGGGGGAA -> TCGGGGGGAAG
CGGTTCTAGGC -> GGTTCTAGGCC
TGGCTTAATTC -> GGCTTAATTCA
TAGTTGGGACT -> AGTTGGGACTT
CTTAGGAGGTG -> TTAGGAGGTGG
CCCCTCGTTCG -> CCCTCGTTCGG
AGCACCAGACG -> GCACCAGACGT
CCAATGGCGAA -> CAATGGCGAAG
GACGAAAGTTG -> ACGAAAGTTGC
GGACGACGTGA -> GACGACGTGAT
GCCGAGTCGGA -> CCGAGTCGGAC
ACCGTGTATTC -> CCGTGTATTCG
AAGGCTGCGCG -> AGGCTGCGCGC
AGTCTCCTTGG -> GTCTCCTTGGG
AGGCAATCAGG -> GGCAATCAGGT
GGGTGAGTGGA -> GGTGAGTGGAC
TAGAACGGAGA -> AGAACGGAGAT
CAACCGCCACA -> AACCGCCACAC
CTCCCCAAAAT -> TCCCCAAAATT
GGCAATCAGGT -> GCAATCAGGTT
TTCGGTGCGAT -> TCGGTGCGATC
AATCCAAGTTA -> ATCCAAGTTAA
ATCTGCCCTCA -> TCTGCCCTCAA
CGGCCAGGGAT -> GGCCAGGGATA
TGGCTCCGAGT -> GGCTCCGAGTC
ATTGGCGGTTC -> TTGGCGGTTCC
GGTCCTTTCCG -> GTCCTTTCCGG
GGAGCTCTAAA -> GAGCTCTAAAT
GGGTACACGAA -> GGTACACGAAG
TAGGGTTTAGG -> AGGGTTTAGGG
ACTCGGGAGGC -> CTCGGGAGGCA
CAGCAATAGGG -> AGCAATAGGGG
CCAGAGGGGCA -> CAGAGGGGCAT
GAACGAACTAC -> AACGAACTACC
CGATCTGCCCT -> GATCTGCCCTC
GATGTCCATTT -> ATGTCCATTTT
GCTCTGTGGAG -> CTCTGTGGAGT
TCCGGACTCCG -> CCGGACTCCGG
AATGAGCGGAA -> ATGAGCGGAAC
CGGACGCCGGT -> GGACGCCGGTG
TGGGACTTGCG -> GGGACTTGCGA
GCATTAAAAGG -> CATTAAAAGGG
TTGGTTCTTAG -> TGGTTCTTAGG
ATTCGGTAATG -> TTCGGTAATGA
AACTGGTTGGC -> ACTGGTTGGCA
CTGTCTCGCAC -> TGTCTCGCACC
CGTGTAGGGTT -> GTGTAGGGTTT
TCACAAGATGC -> CACAAGATGCT
CGATATACCCC -> GATATACCCCA
GAAAAAATGGG -> AAAAAATGGGG
TCATCTGAAGA -> CATCTGAAGAA
GAGAATCTACA -> AGAATCTACAA
GATAATCTGGT -> ATAATCTGGTA
TGCTTCAGGAG -> GCTTCAGGAGG
GGGCAAGACAT -> GGCAAGACATT
ATGTGTCGCCG -> TGTGTCGCCGG
TAAAGGACGAC -> AAAGGACGACG
CCTCTTCCCGC -> CTCTTCCCGCA
GGAAGCATTGG -> GAAGCATTGGC
CGTAGTTCAAC -> GTAGTTCAACC
CCATAAAACGA -> CATAAAACGAG
TCCTACGGGTG -> CCTACGGGTGA
TGCTACAACTG -> GCTACAACTGG
GATGCTCTGTG -> ATGCTCTGTGG
GGATAGTGGAC -> GATAGTGGACC
ATGACTTGGCT -> TGACTTGGCTT
GCGGGAAGGAT -> CGGGAAGGATG
ATACGCTTGTG -> TACGCTTGTGT
CTTGTGTGAAC -> TTGTGTGAACT
GAACTCAAAAC -> AACTCAAAACG
TGGCAATGAGC -> GGCAATGAGCG
ACCCTGACCAA -> CCCTGACCAAT
GTTCATTAAGA -> TTCATTAAGAT
TCTTAGGAGGT -> CTTAGGAGGTG
TCTGCTACGAT -> CTGCTACGATG
ATGGGGAAGCA -> TGGGGAAGCAT
TGGATGTCCAT -> GGATGTCCATT
TTGCGGGTGAG -> TGCGGGTGAGC
AGTCGGACTGG -> GTCGGACTGGA
CGAGTCACACT -> GAGTCACACTG
TACCCCCTCGT -> ACCCCCTCGTT
ATGCCCGCCAC -> TGCCCGCCACA
TTGGCGGTTCC -> TGGCGGTTCCT
GGGGAAGGACG -> GGGAAGGACGG
GTTGGCAATGA -> TTGGCAATGAG
AATCCTTGTTG -> ATCCTTGTTGG
CCCTTGAACGG -> CCTTGAACGGA
TGTTGGTGACC -> GTTGGTGACCT
GGTGCTACAAC -> GTGCTACAACT
GTTTTGGCAGA -> TTTTGGCAGAA
GTAGTGGGCAG -> TAGTGGGCAGC
CCAAGTTAATC -> CAAGTTAATCC
GGAATCTCACG -> GAATCTCACGG
CTACGGGTGAG -> TACGGGTGAGT
TACGATGTCGT -> ACGATGTCGTA
GAGAAAAGTGT -> AGAAAAGTGTC
TAGACCTGAAT -> AGACCTGAATT
GGCCCCCTCGT -> GCCCCCTCGTG
TTGGCTCCCCA -> TGGCTCCCCAA
AATCCCAATGT -> ATCCCAATGTT
ATAAGCTCGCA -> TAAGCTCGCAC
GGTGAACTCAA -> GTGAACTCAAA
CCGCGGACGCC -> CGCGGACGCCG
ATTTATTTACC -> TTTATTTACCA
TCTCACGGGCG -> CTCACGGGCGG
GGGGCGGTCCT -> GGGCGGTCCTT
CTACAACTGGC -> TACAACTGGCA
CTGGCACCTTG -> TGGCACCTTGG
AGCAGCAGACA -> GCAGCAGACAT
GAGCACTATAA -> AGCACTATAAG
GCACTTGCGGG -> CACTTGCGGGT
CCGAGGGGAAT -> CGAGGGGAATC
CGGTAATGAGC -> GGTAATGAGCG
GTTCTAGGCCC -> TTCTAGGCCCG
AGGCAAGGTGC -> GGCAAGGTGCT
CTGGCCCAGTA -> TGGCCCAGTAA
CTACGATGTCG -> TACGATGTCGT
AGGGTACAGGT -> GGGTACAGGTG
GCGATCCACGT -> CGATCCACGTG
ATAATATACTA -> TAATATACTAG
AGAACCCTGAC -> GAACCCTGACC
AATGCTTGTTC -> ATGCTTGTTCC
TGCAAATCTCT -> GCAAATCTCTA
TGGCAACTCGT -> GGCAACTCGTA
TGGCATAGGTG -> GGCATAGGTGG
GCATCCCTTGA -> CATCCCTTGAT
TGAAGAATATA -> GAAGAATATAT
GCATACTGAGC -> CATACTGAGCA
TAGTAGCCGAG -> AGTAGCCGAGT
ACTCTCAAATC -> CTCTCAAATCC
AGATAGTAGCC -> GATAGTAGCCG
GATCAATTCTT -> ATCAATTCTTC
TGCGATCCACG -> GCGATCCACGT
AAATTTGCGGC -> AATTTGCGGCG
TTCAGGAGGTT -> TCAGGAGGTTA
GGAGTTACCGG -> GAGTTACCGGC
GAATCACGACT -> AATCACGACTA
TGAGTTATACG -> GAGTTATACGG
AACTCGTACCA -> ACTCGTACCAG
GAACCCTGTAG -> AACCCTGTAGA
AGGGGCGGTCC -> GGGGCGGTCCT
CGTGCCGGTTC -> GTGCCGGTTCT
CCGCAAGGGCT -> CGCAAGGGCTT
GAATAAGTGCG -> AATAAGTGCGT
TGCAAGCGTAT -> GCAAGCGTATT
ATATAGTACCG -> TATAGTACCGG
TGTCCATTTTC -> GTCCATTTTCT
ACCAGACGTAA -> CCAGACGTAAT
TCTCCTTGGGA -> CTCCTTGGGAC
CAGGAATAAGT -> AGGAATAAGTG
ACAAGCGGCTG -> CAAGCGGCTGT
AACTGAGTTAT -> ACTGAGTTATA
GGTTCTTAGGA -> GTTCTTAGGAG
GCTCAGCGAGC -> CTCAGCGAGCG
CACCAGCACCT -> ACCAGCACCTC
ACAGGTGAACT -> CAGGTGAACTC
TATTCCGAGGG -> ATTCCGAGGGG
TTCTAGGCCCG -> TCTAGGCCCGG
TTTAATGTCAA -> TTAATGTCAAA
TAGCCGAGTCG -> AGCCGAGTCGG
CTGATCCGTAC -> TGATCCGTACC
CCGGCTCAGCG -> CGGCTCAGCGA
GTGTCGCCGGG -> TGTCGCCGGGA
GATGGGTGATT -> ATGGGTGATTT
CTTTGTAATAT -> TTTGTAATATA
GAGTGTCCGAG -> AGTGTCCGAGA
CAGGCGCCGTG -> AGGCGCCGTGG
AGCGTATTGGC -> GCGTATTGGCT
GCTGCGCGCTA -> CTGCGCGCTAG
TCTGGTAAGGG -> CTGGTAAGGGT
TGATCCGTACC -> GATCCGTACCC
GGCCTCAGGCA -> GCCTCAGGCAT
TGGCAGAATCA -> GGCAGAATCAC
GTGAACTCAAA -> TGAACTCAAAA
CATTAGTGGTA -> ATTAGTGGTAG
GGGCACTCGGG -> GGCACTCGGGA
ATAGTACCGGA -> TAGTACCGGAA
AGATAATGCCC -> GATAATGCCCG
TGTCGGGAAAA -> GTCGGGAAAAA
TCAAATGGAGC -> CAAATGGAGCC
GAACGGACCGT -> AACGGACCGTA
ACTGAGCACTA -> CTGAGCACTAT
CATGGCACGTG -> ATGGCACGTGA
ACATCCACTCA -> CATCCACTCAG
AGGTGATACGA -> GGTGATACGAA
TATCTATCCTA -> ATCTATCCTAG
GTCTTGGCATT -> TCTTGGCATTA
TCTGCCCTCAA -> CTGCCCTCAAA
CGGTGCTCCAG -> GGTGCTCCAGA
CACCTTGGGGG -> ACCTTGGGGGG
CGAACTACCGT -> GAACTACCGTC
TTCTTAGGAGG -> TCTTAGGAGGT
GGGTGATTTAA -> GGTGATTTAAT
AGCGTTATCGC -> GCGTTATCGCG
AGGCGGGAAGG -> GGCGGGAAGGA
ACCGGGTACAC -> CCGGGTACACG
CCCTTTGCTGC -> CCTTTGCTGCA
TGAGCAATCGG -> GAGCAATCGGA
CTTTATTACAT -> TTTATTACATT
TGCTCCAGATA -> GCTCCAGATAG
CGTGGCTTAAT -> GTGGCTTAATT
GAGGTGGAGAA -> AGGTGGAGAAA
TGTAGGGTTTA -> GTAGGGTTTAG
AGCGAGCGTAT -> GCGAGCGTATG
TGGCGGTTCCT -> GGCGGTTCCTT
CAGCAGACATG -> AGCAGACATGG
GCTTAATTTCT -> CTTAATTTCTG
CGGACTGGATG -> GGACTGGATGT
TTCAGATCCAT -> TCAGATCCATC
TCAGATCCATC -> CAGATCCATCA
CCGGTTCTAGG -> CGGTTCTAGGC
ACACATTCTGC -> CACATTCTGCT
ATTGGCTCCCC -> TTGGCTCCCCA
CCAGACGTAAT -> CAGACGTAATT
TCGTGCCGGTT -> CGTGCCGGTTC
TCACGAATCCA -> CACGAATCCAA
CGGTTGGCAAC -> GGTTGGCAACT
GCGATTCACGA -> CGATTCACGAA
ACGCTTGTGTG -> CGCTTGTGTGA
TAATGTCAAAC -> AATGTCAAACT
ACGGTGGGCTG -> CGGTGGGCTGG
TATACGGTTGG -> ATACGGTTGGC
AAACTGAGTTA -> AACTGAGTTAT
TTGATGGTAGT -> TGATGGTAGTA
ACTCAGCAATA -> CTCAGCAATAG
GCAGCGATACT -> CAGCGATACTC
GAAGAATATAT -> AAGAATATATA
GTGACCTTTGT -> TGACCTTTGTA
GGTGGAGAAAA -> GTGGAGAAAAA
GGCCGCAAGGG -> GCCGCAAGGGC
CCCACACATTC -> CCACACATTCT
ATAAGTGCGTA -> TAAGTGCGTAG
GTTTGCTTCAG -> TTTGCTTCAGG
TTATTACATTA -> TATTACATTAG
TCGCACTTGCG -> CGCACTTGCGG
GTCGGACTGGA -> TCGGACTGGAT
GGTATACGCTT -> GTATACGCTTG
TAGGCCCGGGA -> AGGCCCGGGAC
CGAGTCGGACT -> GAGTCGGACTG
TGATTTAATGT -> GATTTAATGTC
TCCCTTGATGG -> CCCTTGATGGT
TGGTGACCTTT -> GGTGACCTTTG
TCTTGCGCGTT -> CTTGCGCGTTT
ATCTACCTTTC -> TCTACCTTTCC
GAAGCATTGGC -> AAGCATTGGCG
ATCCCTTGATG -> TCCCTTGATGG
CATTTCTGGCA -> ATTTCTGGCAC
CCTTTCCTCGG -> CTTTCCTCGGA
TATACTAGCCC -> ATACTAGCCCA
GATGTCGGGAA -> ATGTCGGGAAA
ACGTGCATCCC -> CGTGCATCCCT
ATACTGAGCAC -> TACTGAGCACT
TTGGTGACCTT -> TGGTGACCTTT
TGGAGCCATTT -> GGAGCCATTTC
TATATCTCTTG -> ATATCTCTTGC
AGAACGGAGAT -> GAACGGAGATT
TGGCGAAGGTT -> GGCGAAGGTTC
CCGCCACACTC -> CGCCACACTCA
CAAAATTTGCG -> AAAATTTGCGG
AACGTTTGCTT -> ACGTTTGCTTC
AATCAATGGAT -> ATCAATGGATG
ACTCAGGAATA -> CTCAGGAATAT
GATACGAACCC -> ATACGAACCCT
GATCCGGCTCA -> ATCCGGCTCAG
AGGCATGTCAA -> GGCATGTCAAT
TCTCAAATCCG -> CTCAAATCCGC
CGGAACGAACT -> GGAACGAACTA
AGCAATCGGAG -> GCAATCGGAGA
CATTGGGACTT -> ATTGGGACTTG
CTGTTGACGCA -> TGTTGACGCAG
CACGACTATCA -> ACGACTATCAT
TTCATTAAGAT -> TCATTAAGATT
ATATATCTCTT -> TATATCTCTTG
GTATTCCGAGG -> TATTCCGAGGG
CACGCACCTTA -> ACGCACCTTAG
CTATAAGAAAC -> TATAAGAAACA
GTTCTTAGGAG -> TTCTTAGGAGG
CACTTGCGGGT -> ACTTGCGGGTG
AAAATTTGCGG -> AAATTTGCGGC
TACGAACCCTG -> ACGAACCCTGT
GTCCATTTTCT -> TCCATTTTCTG
GACGGTGGGCT -> ACGGTGGGCTG
GGTTGGTTCTT -> GTTGGTTCTTA
TGTAATATATC -> GTAATATATCT
CTGCTACGATG -> TGCTACGATGT
ACGAAAGTTGC -> CGAAAGTTGCT
ACATTAGTGGT -> CATTAGTGGTA
TGAGGCTTAAT -> GAGGCTTAATT
TGGAGAAAAAG -> GGAGAAAAAGT
CCCATGAGTGT -> CCATGAGTGTC
TCTAAATACAA -> CTAAATACAAC
GTAGAAACTGA -> TAGAAACTGAG
GGCACGCACCT -> GCACGCACCTT
CTCCGGCAGAG -> TCCGGCAGAGC
ACTCGAACGTT -> CTCGAACGTTT
CGCCTTCACAA -> GCCTTCACAAG
ACTCAGGCAAG -> CTCAGGCAAGG
TATTACATTAG -> ATTACATTAGT
ATCCTAGAAGG -> TCCTAGAAGGT
GATTTCGAGAC -> ATTTCGAGACC
TTGACGCAGAC -> TGACGCAGACC
CCTTTGCTGCA -> CTTTGCTGCAA
CTTTGCTGCAA -> TTTGCTGCAAG
CCCAAAATTTG -> CCAAAATTTGC
GCCCCCTCGTG -> CCCCCTCGTGG
AAGCGGCTGTC -> AGCGGCTGTCT
CCAATGTTGTC -> CAATGTTGTCC
TACGGGTGAGT -> ACGGGTGAGTG
CTCCAGATAGT -> TCCAGATAGTA
TTACATTAGTG -> TACATTAGTGG
TTAGCTGTTGC -> TAGCTGTTGCC
ATATATAGTAC -> TATATAGTACC
TCTGAGAAAAG -> CTGAGAAAAGT
TCCACTCAGCA -> CCACTCAGCAA
TTCACAAGATG -> TCACAAGATGC
AATTTCTGTCG -> ATTTCTGTCGA
CCACACTCAGG -> CACACTCAGGA
CATCCAGAGTA -> ATCCAGAGTAG
CTCTGGCCCAG -> TCTGGCCCAGT
AAAAAATGGGG -> AAAAATGGGGA
GGCCAAGAGGG -> GCCAAGAGGGG
CGCTCCTCTTC -> GCTCCTCTTCC
CCATCATCTGA -> CATCATCTGAA
GTATATAATAT -> TATATAATATA
GGCAAGGTGCT -> GCAAGGTGCTA
CGGGAAGGATG -> GGGAAGGATGA
TTGAGGCTTAA -> TGAGGCTTAAT
ACTCAAAACGG -> CTCAAAACGGC
TCGACGTACAT -> CGACGTACATC
ACCGTATTCCG -> CCGTATTCCGA
AGTTATACGGT -> GTTATACGGTT
TACGATATACC -> ACGATATACCC
CATTGGCGGTT -> ATTGGCGGTTC
CTGACACCTGA -> TGACACCTGAT
GTCGGGAAAAA -> TCGGGAAAAAA
CACGTGATTTC -> ACGTGATTTCG
CGGAGAACCCT -> GGAGAACCCTG
TGTTGAGGCAA -> GTTGAGGCAAT
CGGACCGATAT -> GGACCGATATA
GCCCTCAAATG -> CCCTCAAATGG
CGAATCCAAGT -> GAATCCAAGTT
CATGAGTGTCC -> ATGAGTGTCCG
GTTGCCTAAAG -> TTGCCTAAAGG
TGTCTCTGGCC -> GTCTCTGGCCC
GATACAGCGCG -> ATACAGCGCGA
CCGCCTTCACA -> CGCCTTCACAA
TCTCTGGCCCA -> CTCTGGCCCAG
CGTTTTGGCAG -> GTTTTGGCAGA
GAAACACTCTG -> AAACACTCTGG
GTGATTGGTTG -> TGATTGGTTGG
CCTCAAATGGA -> CTCAAATGGAG
TCCAGATAGTA -> CCAGATAGTAG
TGGTAAGGGTA -> GGTAAGGGTAC
TGTCGTAGTTC -> GTCGTAGTTCA
GAATATATAGT -> AATATATAGTA
GTGGGCTGGAG -> TGGGCTGGAGA
CACCAGACGTA -> ACCAGACGTAA
CCATTTTCTGT -> CATTTTCTGTA
AGGACGACGTG -> GGACGACGTGA
CGGGTACACGA -> GGGTACACGAA
ATACCCCAACG -> TACCCCAACGG
ATTCACGAATC -> TTCACGAATCC
GTACCCCCTCG -> TACCCCCTCGT
TACTCTCAAAT -> ACTCTCAAATC
TCAGGCGCCGT -> CAGGCGCCGTG
ATAGTTGGGAC -> TAGTTGGGACT
GGCGCCGTGGC -> GCGCCGTGGCT
CGAGCGTATGG -> GAGCGTATGGA
TGAACAGGGGT -> GAACAGGGGTG
ATATACCCCAA -> TATACCCCAAC
GCGCCTTTGTA -> CGCCTTTGTAA
TTCTGGCACCT -> TCTGGCACCTT
CTAAAGGTATC -> TAAAGGTATCT
CAATAGGGGAG -> AATAGGGGAGC
CGCCGGGATAG -> GCCGGGATAGT
AACTCAGGCAA -> ACTCAGGCAAG
GGCTTGAGGCT -> GCTTGAGGCTT
AGACCTTAGCT -> GACCTTAGCTC
TCACGACCTAT -> CACGACCTATA
TACAGCGCGAC -> ACAGCGCGACC
AGTTGCTCGCG -> GTTGCTCGCGG
AATTTGCGGCG -> ATTTGCGGCGC
CGTTATCGCGG -> GTTATCGCGGA
TAAAAGGGCAT -> AAAAGGGCATA
GTGAGTGGACT -> TGAGTGGACTC
AATCTGGTAAG -> ATCTGGTAAGG
CTTAATTCAGC -> TTAATTCAGCA
ATTAAGATTCT -> TTAAGATTCTT
ACATGTGAACA -> CATGTGAACAG
AAGGATGTCGG -> AGGATGTCGGG
GCAATCGGAGA -> CAATCGGAGAA
TCTGAAGAATA -> CTGAAGAATAT
AGTGGTAGATG -> GTGGTAGATGG
AGGTGTATATA -> GGTGTATATAA
CGCAGTAGGCC -> GCAGTAGGCCA
CTCTTGCGCGT -> TCTTGCGCGTT
GACTTGGCTTC -> ACTTGGCTTCT
GGTGCGATCCA -> GTGCGATCCAC
TTAAAGGAGCC -> TAAAGGAGCCC
CATACTGAGCA -> ATACTGAGCAC
CCGATATAGAT -> CGATATAGATG
GCGTAGACCTG -> CGTAGACCTGA
AGAGGGGCGGT -> GAGGGGCGGTC
CAAATGGAGCC -> AAATGGAGCCA
AAACACTCTGG -> AACACTCTGGG
CCGAGTCTCCT -> CGAGTCTCCTT
TCAAACTCAGG -> CAAACTCAGGC
GCGGAACGAAC -> CGGAACGAACT
AACGGACCGAT -> ACGGACCGATA
CCATCAGGCGC -> CATCAGGCGCC
ACAACTGGCAT -> CAACTGGCATA
GAAGGATGACG -> AAGGATGACGC
CCTTGGCTCCG -> CTTGGCTCCGA
AGGAATAAGTG -> GGAATAAGTGC
GGTAGATGGGT -> GTAGATGGGTG
TGGCACGTGAT -> GGCACGTGATT
AGGGTTTAGGG -> GGGTTTAGGGA
TTAAGATTCTT -> TAAGATTCTTC
GGTTCCTACGG -> GTTCCTACGGG
GGGTTTAGGGA -> GGTTTAGGGAT
GCGTTTTGGCA -> CGTTTTGGCAG
CCAGGGATACT -> CAGGGATACTC
GATGGAGATAA -> ATGGAGATAAT
TTAGTGGTAGA -> TAGTGGTAGAT
AATGCCCGCCA -> ATGCCCGCCAC
GTCCCATGAGT -> TCCCATGAGTG
AAGATCAATTC -> AGATCAATTCT
GCAACTCGTAC -> CAACTCGTACC
AACACTCTGGG -> ACACTCTGGGA
GATGACTTGGC -> ATGACTTGGCT
GAAAAGTGTCT -> AAAAGTGTCTC
CGTGCATCCCT -> GTGCATCCCTT
ACCTTAGCTGT -> CCTTAGCTGTT
TCCTCTTCCCG -> CCTCTTCCCGC
TAGTAATGGAC -> AGTAATGGACG
ACCCCAACGGA -> CCCCAACGGAC
CGCCACACTGA -> GCCACACTGAC
GAACCCTGACC -> AACCCTGACCA
CAGCAGCAGAC -> AGCAGCAGACA
ACGGAGATTAT -> CGGAGATTATC
ACGACTATCAT -> CGACTATCATT
AATAAGTGCGT -> ATAAGTGCGTA
TCCGGCTCAGC -> CCGGCTCAGCG
GGGCAGCGATA -> GGCAGCGATAC
TTCTGTAGTGG -> TCTGTAGTGGG
TCAACCAGAGG -> CAACCAGAGGG
TACCTTTCCTC -> ACCTTTCCTCG
GAGCACCAGAC -> AGCACCAGACG
ATACTCTGAAC -> TACTCTGAACG
CGCGCTAGTCT -> GCGCTAGTCTT
TAAAGGAGCCC -> AAAGGAGCCCG
GACTTGCGATT -> ACTTGCGATTC
GACACCTGATC -> ACACCTGATCC
CTGGTTGGCAA -> TGGTTGGCAAT
TGTCCCATGAG -> GTCCCATGAGT
TGGTTGGTTCT -> GGTTGGTTCTT
CTTGTTGGTGA -> TTGTTGGTGAC
GACGCAGACCT -> ACGCAGACCTT
TACCGGAATGT -> ACCGGAATGTG
TGTCTCGCACC -> GTCTCGCACCG
CGGTAAGGATG -> GGTAAGGATGT
TGGGACATCAC -> GGGACATCACG
AAGAGGGGCGG -> AGAGGGGCGGT
GGGCGGTCCTT -> GGCGGTCCTTT
GCCTTCACAAG -> CCTTCACAAGA
AGTAAAGGACG -> GTAAAGGACGA
ATAGATGGAGA -> TAGATGGAGAT
AGCGTATGGAG -> GCGTATGGAGG
CCCTCGTGGGT -> CCTCGTGGGTA
GCTAGTCTTGG -> CTAGTCTTGGC
TAGTACCGGAA -> AGTACCGGAAT
GCTCCTCTTCC -> CTCCTCTTCCC
ATGAGCGGAAC -> TGAGCGGAACG
GACGCCAAAGA -> ACGCCAAAGAT
ATCAGGTTCAT -> TCAGGTTCATT
GGTGCGCCTTT -> GTGCGCCTTTG
GTGTATATAAT -> TGTATATAATA
CCGGCAGAGCA -> CGGCAGAGCAC
GGATACTCTGA -> GATACTCTGAA
CCACCGATCCG -> CACCGATCCGG
TTTGCTGCAAG -> TTGCTGCAAGC
TCAGGAGGTTA -> CAGGAGGTTAA
CAACCTATGTC -> AACCTATGTCG
GCACCAGCACC -> CACCAGCACCT
CCTTGAACGGA -> CTTGAACGGAC
TCCGTACCCCC -> CCGTACCCCCT
TGATGGTAGTA -> GATGGTAGTAA
CGGTTCCTTGG -> GGTTCCTTGGC
CGTAGACCTGA -> GTAGACCTGAA
ACTTGCGATTC -> CTTGCGATTCA
CTCAGATAATG -> TCAGATAATGC
GACGTAATTGA -> ACGTAATTGAC
GTGATTTCGAG -> TGATTTCGAGA
CGATATAGATG -> GATATAGATGG
ACCTATGTCGG -> CCTATGTCGGT
ATGCTTGTTCC -> TGCTTGTTCCA
GCTTGTTCCAT -> CTTGTTCCATC
ATACAACCGCC -> TACAACCGCCA
GTCCGCCCTTG -> TCCGCCCTTGA
CGGCTGTCTCG -> GGCTGTCTCGC
GGAAAAAATGG -> GAAAAAATGGG
TCTTCGGGGGG -> CTTCGGGGGGA
GAGGTTAAAGG -> AGGTTAAAGGA
GTTAATCCCAA -> TTAATCCCAAT
ACCAGCCTGTC -> CCAGCCTGTCT
TCGAACGTTTG -> CGAACGTTTGC
CGGACCGTATT -> GGACCGTATTC
CCTGTCTCTGG -> CTGTCTCTGGC
ATAGGTGGCCG -> TAGGTGGCCGC
GCCAGGGATAC -> CCAGGGATACT
GGCACGTGATT -> GCACGTGATTT
ATGTCGTAGTT -> TGTCGTAGTTC
GGTAGTAATGG -> GTAGTAATGGA
ATATAGATGGA -> TATAGATGGAG
CTGAGCACTAT -> TGAGCACTATA
GTCTCTACGAT -> TCTCTACGATA
TGCGGCGCAGT -> GCGGCGCAGTA
GGTGATACGAA -> GTGATACGAAC
CCAGATAGTAG -> CAGATAGTAGC
GCGCGTTTTGG -> CGCGTTTTGGC
TTCCGAGGGGA -> TCCGAGGGGAA
CCAGTAAAGGA -> CAGTAAAGGAC
AATCCGCTTAA -> ATCCGCTTAAT
CTCGTGCCGGT -> TCGTGCCGGTT
GACGTACATCC -> ACGTACATCCA
GTATTCAGATC -> TATTCAGATCC
AGCAATAGGGG -> GCAATAGGGGA
AAGAATATATA -> AGAATATATAG
CATCCCTTGAT -> ATCCCTTGATG
TACAACTGGCA -> ACAACTGGCAT
GCAAGGGCTTG -> CAAGGGCTTGA
TGGACCACCCA -> GGACCACCCAT
CCAGGAATAAG -> CAGGAATAAGT
AAGGTTCCTAC -> AGGTTCCTACG
CTTTCCGGACT -> TTTCCGGACTC
CTTCCCGCAGG -> TTCCCGCAGGT
GGAGAACCCTG -> GAGAACCCTGA
TGGAGACGAAA -> GGAGACGAAAG
CTCTACGATAT -> TCTACGATATA
GCTTGTGTGAA -> CTTGTGTGAAC
GGTGGGCTGGA -> GTGGGCTGGAG
TTTCCTCGGAC -> TTCCTCGGACC
CGGGATAGTGG -> GGGATAGTGGA
TGGTAGTAATG -> GGTAGTAATGG
GGAGACGAAAG -> GAGACGAAAGT
ATCCGTACCCC -> TCCGTACCCCC
TCAGCGAGCGT -> CAGCGAGCGTA
TACTGAGCACT -> ACTGAGCACTA
TCTAGGCCCGG -> CTAGGCCCGGG
GTAATATATCT -> TAATATATCTC
TGCGTAGACCT -> GCGTAGACCTG
GAGGCAATCAG -> AGGCAATCAGG
AGATTCTTCCT -> GATTCTTCCTT
TGCATCCCTTG -> GCATCCCTTGA
AGTGGACCACC -> GTGGACCACCC
CTCAGGCAAGG -> TCAGGCAAGGT
GGCTCAGCGAG -> GCTCAGCGAGC
GTTTAGGGATA -> TTTAGGGATAC
GGTGCAAATCT -> GTGCAAATCTC
GGAGGTGTATA -> GAGGTGTATAT
CGTTTGCTTCA -> GTTTGCTTCAG
AGAGTAGAAAC -> GAGTAGAAACT
TGCGCGTTTTG -> GCGCGTTTTGG
GGTGCTCCAGA -> GTGCTCCAGAT
ATTCTGCTACG -> TTCTGCTACGA
TCGGTAAGGAT -> CGGTAAGGATG
GGCATACTGAG -> GCATACTGAGC
GCCCGCCACAC -> CCCGCCACACT
TAATATATCTC -> AATATATCTCT
CCTCGTGGGTA -> CTCGTGGGTAT
CCTTGGGACAT -> CTTGGGACATC
CTCGGACCCTT -> TCGGACCCTTT
CCCGGGACATG -> CCGGGACATGT
TCTCTACGATA -> CTCTACGATAT
CAAAACGGCCT -> AAAACGGCCTC
CTGGGAGTGAA -> TGGGAGTGAAT
AGGCGCCGTGG -> GGCGCCGTGGC
ATGGAGCCATT -> TGGAGCCATTT
TAGGAGGTGGA -> AGGAGGTGGAG
CAAGCGTATTG -> AAGCGTATTGG
CCTTGATGGTA -> CTTGATGGTAG
GAGTCTCCTTG -> AGTCTCCTTGG
GCTGTCTCGCA -> CTGTCTCGCAC
ACCGCGGACGC -> CCGCGGACGCC
CAAGGGCTTGA -> AAGGGCTTGAG
GACGCTCCTCT -> ACGCTCCTCTT
CAGAATCACGA -> AGAATCACGAC
CGAAAGTTGCT -> GAAAGTTGCTC
GGACCACCCAT -> GACCACCCATA
GGTAATGAGCG -> GTAATGAGCGA
AAATGGGGAAG -> AATGGGGAAGC
ACCTGAATTCG -> CCTGAATTCGG
TTGCTGCAAGC -> TGCTGCAAGCG
GCACCTTAGCT -> CACCTTAGCTG
ATATCTCTTGC -> TATCTCTTGCG
TTGCGATTCAC -> TGCGATTCACG
TAATGCCCGCC -> AATGCCCGCCA
AGCTCGTGCCG -> GCTCGTGCCGG
TGAACGGTAAG -> GAACGGTAAGG
GTCAAACTCAG -> TCAAACTCAGG
CGCGTTTTGGC -> GCGTTTTGGCA
TTCCGGACTCC -> TCCGGACTCCG
CTAGCCCACAC -> TAGCCCACACA
TCAGGCATGTC -> CAGGCATGTCA
GAGTTACCGGC -> AGTTACCGGCC
CCAGCACCTCA -> CAGCACCTCAG
TTAATGTCAAA -> TAATGTCAAAC
GGGGGTGCAAA -> GGGGTGCAAAT
AGGTGCTACAA -> GGTGCTACAAC
ACGTGATTTCG -> CGTGATTTCGA
TAATGGACGCC -> AATGGACGCCA
ACTACCGTCAT -> CTACCGTCATA
GTAATGAGCGA -> TAATGAGCGAT
ACCGATCCGGC -> CCGATCCGGCT
TTTCTGTCGAC -> TTCTGTCGACG
CTCAAAACGGC -> TCAAAACGGCC
GCAAGACATTC -> CAAGACATTCC
CTCGCACCGCG -> TCGCACCGCGG
GCTCTAAATAC -> CTCTAAATACA
GGTTGGCAACT -> GTTGGCAACTC
TCTGTCGACGT -> CTGTCGACGTA
ACTCTGGGAGT -> CTCTGGGAGTG
GGGACTTTAGG -> GGACTTTAGGC
TTATCGCGGAT -> TATCGCGGATG
GGATGACTTGG -> GATGACTTGGC
GCTGTTGCCTA -> CTGTTGCCTAA
CCTTAGCTCGT -> CTTAGCTCGTG
AATGGAGCCAT -> ATGGAGCCATT
GGAGTGAATCC -> GAGTGAATCCT
GCCTGTCTCTG -> CCTGTCTCTGG
CACTCAGGAAT -> ACTCAGGAATA
CGCACCGCGGA -> GCACCGCGGAC
TCCGAGGGGAA -> CCGAGGGGAAT
AAGTGTCTCTA -> AGTGTCTCTAC
ATCTCACGGGC -> TCTCACGGGCG
ATTTTCTGTAG -> TTTTCTGTAGT
CGTACCAGCGT -> GTACCAGCGTT
GTTGCTCGCGG -> TTGCTCGCGGA
AAGGGCTTGAG -> AGGGCTTGAGG
GATAGTAGCCG -> ATAGTAGCCGA
ACGATGTCGTA -> CGATGTCGTAG
TCCGGCAGAGC -> CCGGCAGAGCA
CACTGTTGACG -> ACTGTTGACGC
TGGTTGGCAAT -> GGTTGGCAATG
GAGAACCCTGA -> AGAACCCTGAC
TATCGCGGATG -> ATCGCGGATGG
CCCAACGGACC -> CCAACGGACCG
ATTGACGTGTA -> TTGACGTGTAG
GGGCTGGAGAC -> GGCTGGAGACG
ACTGTTGACGC -> CTGTTGACGCA
CGCAGACCTTA -> GCAGACCTTAG
ACGTTTGCTTC -> CGTTTGCTTCA
GCATTGGCGGT -> CATTGGCGGTT
GCACCGCGGAC -> CACCGCGGACG
AAAAAGTCCAG -> AAAAGTCCAGG
TTCCATCAGGC -> TCCATCAGGCG
TGCCCGCCACA -> GCCCGCCACAC
ATCCGCTTAAT -> TCCGCTTAATG
TTACCAGCCTG -> TACCAGCCTGT
CTTCCTTACTC -> TTCCTTACTCG
TTGAACGGACC -> TGAACGGACCG
TCGCCGGGATA -> CGCCGGGATAG
GAGGGGAATCT -> AGGGGAATCTC
GGATACAGCGC -> GATACAGCGCG
GATAATGCCCG -> ATAATGCCCGC
CATCTGAAGAA -> ATCTGAAGAAT
AGGCTGCGCGC -> GGCTGCGCGCT
ACGAAGGCTGC -> CGAAGGCTGCG
TTATTTACCAG -> TATTTACCAGC
CGTATGGAGGT -> GTATGGAGGTG
TAGTCTTGGCA -> AGTCTTGGCAT
TACTCGAACGT -> ACTCGAACGTT
GAATCTACAAG -> AATCTACAAGC
GGGCATTGGGA -> GGCATTGGGAC
TCTACAAGCGG -> CTACAAGCGGC
GTGGGTATACG -> TGGGTATACGC
CAGGGGTGCGC -> AGGGGTGCGCC
CCGGCCAGGGA -> CGGCCAGGGAT
TTCAACCAGAG -> TCAACCAGAGG
GGAGATAATCT -> GAGATAATCTG
ACACTGTTGAC -> CACTGTTGACG
ATCACGACTAT -> TCACGACTATC
TAATTCAGCAG -> AATTCAGCAGC
TTCGGGCAAGA -> TCGGGCAAGAC
GTGTATTCGGT -> TGTATTCGGTA
CGGGTGAGTGG -> GGGTGAGTGGA
CGGTGGGCTGG -> GGTGGGCTGGA
TAATTGACGTG -> AATTGACGTGT
AGGCCCCCTCG -> GGCCCCCTCGT
CCGAGTCGGAC -> CGAGTCGGACT
CTCTGGGAGTG -> TCTGGGAGTGA
CAAATCTCTAA -> AAATCTCTAAG
ATCAATTCTTC -> TCAATTCTTCG
AGATCCATCAT -> GATCCATCATC
GTAAAGGACGA -> TAAAGGACGAC
TGGCATTAAAA -> GGCATTAAAAG
GGGCATACTGA -> GGCATACTGAG
GACCAATCAAT -> ACCAATCAATG
CTCAAATCCGC -> TCAAATCCGCT
TCCTTACTCGA -> CCTTACTCGAA
AGTGGACTCTA -> GTGGACTCTAG
CTTTCCTCGGA -> TTTCCTCGGAC
GTGCGTAGACC -> TGCGTAGACCT
GGACGCCGGTG -> GACGCCGGTGC
TGACACCTGAT -> GACACCTGATC
CTCGTACCAGC -> TCGTACCAGCG
GTTGGTGACCT -> TTGGTGACCTT
GGTTCCTTGGC -> GTTCCTTGGCT
CGACGTACATC -> GACGTACATCC
CAATGAGCGGA -> AATGAGCGGAA
CAAATCCGCTT -> AAATCCGCTTA
GGACTTGCGAT -> GACTTGCGATT
CTACCTTTCCT -> TACCTTTCCTC
GCGCTAGTCTT -> CGCTAGTCTTG
CTTGGCTCCGA -> TTGGCTCCGAG
TTTGCTTCAGG -> TTGCTTCAGGA
AGTGCGTAGAC -> GTGCGTAGACC
TGTCCGAGAAT -> GTCCGAGAATC
AGACATGGCAC -> GACATGGCACG
TTGCTTCAGGA -> TGCTTCAGGAG
ATCCCAATGTT -> TCCCAATGTTG
AGATGTTGAGG -> GATGTTGAGGC
GCAAGGTGCTA -> CAAGGTGCTAC
ATAAAACGAGT -> TAAAACGAGTC
TCCCATGAGTG -> CCCATGAGTGT
GGAAGGACGGT -> GAAGGACGGTG
AGGCCCGGGAC -> GGCCCGGGACA
CCTTTGTAATA -> CTTTGTAATAT, CTTTGTAATAC
GCCACACTCAG -> CCACACTCAGG
TGCTACGATGT -> GCTACGATGTC
GACCGTGTATT -> ACCGTGTATTC
TGTGTCGCCGG -> GTGTCGCCGGG
CTGACCAATCA -> TGACCAATCAA
CTCAAATGGAG -> TCAAATGGAGC
AATGAGCGATC -> ATGAGCGATCT
CAATCGGAGAA -> AATCGGAGAAC
TAATGCTTGTT -> AATGCTTGTTC
ACATCACGACC -> CATCACGACCT
TGTCGCCGGGA -> GTCGCCGGGAT
CTTAGCTGTTG -> TTAGCTGTTGC
GGGTACAGGTG -> GGTACAGGTGA
AGAGGGGCATT -> GAGGGGCATTG
GGCATTGGGAC -> GCATTGGGACT
CCCCCTCGTGG -> CCCCTCGTGGG
ATTCCCGTGCT -> TTCCCGTGCTT
TGTCAAACTCA -> GTCAAACTCAG
GCAGTAGGCCA -> CAGTAGGCCAA
ACACCTGATCC -> CACCTGATCCG
ACGGACCGATA -> CGGACCGATAT
CGATTCACGAA -> GATTCACGAAT
GACATTCCCGT -> ACATTCCCGTG
CAGGTTCATTA -> AGGTTCATTAA
GGACATGTGAA -> GACATGTGAAC
TCCCAATGTTG -> CCCAATGTTGT
ACCGTCATAGT -> CCGTCATAGTT
GCAATGAGCGG -> CAATGAGCGGA
GAATTCGGGCA -> AATTCGGGCAA
AGCAGACATGG -> GCAGACATGGC
TTTGTAATACA -> TTGTAATACAT
TTGGCATTAAA -> TGGCATTAAAA
GGCAGAGCACC -> GCAGAGCACCA
CTGCGCGCTAG -> TGCGCGCTAGT
AGCGATCTGCC -> GCGATCTGCCC
AGGATGACGCT -> GGATGACGCTC
GTGGCCGCAAG -> TGGCCGCAAGG
ACACGAAGGCT -> CACGAAGGCTG
ATTGGGACTTG -> TTGGGACTTGC
GATCTGCCCTC -> ATCTGCCCTCA
TACCGGGTACA -> ACCGGGTACAC
TCGGGCAAGAC -> CGGGCAAGACA
TCCGCTTAATG -> CCGCTTAATGC
TCAGGTTCATT -> CAGGTTCATTA
CATTAAGATTC -> ATTAAGATTCT
TGAGCGGAACG -> GAGCGGAACGA
GGGGAGCTCTA -> GGGAGCTCTAA
TGTTGCCTAAA -> GTTGCCTAAAG
GTTCGGTGCGA -> TTCGGTGCGAT
CACGGGCGGGA -> ACGGGCGGGAG
GATCCACGTGC -> ATCCACGTGCA
TCAAAACGGCC -> CAAAACGGCCT
GGATGGTATTC -> GATGGTATTCA
TTCCTTACTCG -> TCCTTACTCGA
CCGTACCCCCT -> CGTACCCCCTC
GCTCGTGCCGG -> CTCGTGCCGGT
GGTCCGCCCTT -> GTCCGCCCTTG
ATAATCTGGTA -> TAATCTGGTAA
TGATTGGTTGG -> GATTGGTTGGT
ACGCAGACCTT -> CGCAGACCTTA
GTTCCTACGGG -> TTCCTACGGGT
ATCCAACCTAT -> TCCAACCTATG
ATTTACCAGCC -> TTTACCAGCCT
TATATAGTACC -> ATATAGTACCG
TCCTTGTTGGT -> CCTTGTTGGTG
AATTGACGTGT -> ATTGACGTGTA
TAGCTGTTGCC -> AGCTGTTGCCT
TTCCTCGGACC -> TCCTCGGACCC
CAGGCATGTCA -> AGGCATGTCAA
TGGTATTCAGA -> GGTATTCAGAT
CGAGGGGAATC -> GAGGGGAATCT
CAATCAATGGA -> AATCAATGGAT
AGTCACACTGT -> GTCACACTGTT
GACGTGATTGG -> ACGTGATTGGT
AAGGTATCTAT -> AGGTATCTATC
TATTCAGATCC -> ATTCAGATCCA
ATTAAAAGGGC -> TTAAAAGGGCA
GATATACCCCA -> ATATACCCCAA
ACGTACATCCA -> CGTACATCCAC
CGATGTCGTAG -> GATGTCGTAGT
AAGGATGACGC -> AGGATGACGCT
TTGCCTAAAGG -> TGCCTAAAGGT
CCGTGTATTCG -> CGTGTATTCGG
ACAACCGCCAC -> CAACCGCCACA
TGAACTCAAAA -> GAACTCAAAAC
TTCACGAATCC -> TCACGAATCCA
CGGAATGTGTC -> GGAATGTGTCG
ACATTATACCG -> CATTATACCGG
TCTCTTGCGCG -> CTCTTGCGCGT
TCGGACCCTTT -> CGGACCCTTTG
TAATACATTAT -> AATACATTATA
ATTGGTTGGTT -> TTGGTTGGTTC
CTCTAAGGGCA -> TCTAAGGGCAC
TGACCAATCAA -> GACCAATCAAT
TCGGGAAAAAA -> CGGGAAAAAAT
AATATACTAGC -> ATATACTAGCC
TTAATTCAGCA -> TAATTCAGCAG
CGGAGATTATC -> GGAGATTATCC
CTCAGGAATAT -> TCAGGAATATC
ATACATTATAC -> TACATTATACC
CCACCCATAAA -> CACCCATAAAA
AGTGAATCCTT -> GTGAATCCTTG
TCAGCAGCAGA -> CAGCAGCAGAC
ATGACGCTCCT -> TGACGCTCCTC
TGGCACCTTGG -> GGCACCTTGGG
GGCAATGAGCG -> GCAATGAGCGG
TGTGAACAGGG -> GTGAACAGGGG
TGGGACTTTAG -> GGGACTTTAGG
CCAAGAGGGGC -> CAAGAGGGGCG
GATTCACGAAT -> ATTCACGAATC
GGGGAATCTCA -> GGGAATCTCAC
GTGGAGAAAAA -> TGGAGAAAAAG
AAAGATCAATT -> AAGATCAATTC
TCAGGCAAGGT -> CAGGCAAGGTG
CTCGGGAGGCA -> TCGGGAGGCAC
AAGACATTCCC -> AGACATTCCCG
CTCAGCGAGCG -> TCAGCGAGCGT
CATAAAACGAG -> ATAAAACGAGT
TAGTGGGCAGC -> AGTGGGCAGCG
TACCGGCCAGG -> ACCGGCCAGGG
GCAATAGGGGA -> CAATAGGGGAG
CCTAGAAGGTG -> CTAGAAGGTGA
GGCCCAGTAAA -> GCCCAGTAAAG
TGGAGATAATC -> GGAGATAATCT
GTCCTTTCCGG -> TCCTTTCCGGA
ACTAGCCCACA -> CTAGCCCACAC
GCTTAATTCAG -> CTTAATTCAGC
AGTGTCTCTAC -> GTGTCTCTACG
CTGGCATAGGT -> TGGCATAGGTG
TGTGTGAACTG -> GTGTGAACTGG
AGACATTCCCG -> GACATTCCCGT
ACCTTGGGGGG -> CCTTGGGGGGT
ACTCTGAACGG -> CTCTGAACGGT
CACTATAAGCT -> ACTATAAGCTC
GCCGGGATAGT -> CCGGGATAGTG
ACGACCTATAA -> CGACCTATAAG
AAGTTAATCCC -> AGTTAATCCCA
GACCTATAAGA -> ACCTATAAGAA
GCAAGCGTATT -> CAAGCGTATTG
TATGTCGGTAA -> ATGTCGGTAAG
ATTACATTAGT -> TTACATTAGTG
TGCGGGTGAGC -> GCGGGTGAGCA
ATGGAGATAAT -> TGGAGATAATC
CTGGAGACGAA -> TGGAGACGAAA
GTATTGGCTCC -> TATTGGCTCCC
GAGGCACGCAC -> AGGCACGCACC
CTGGTAAGGGT -> TGGTAAGGGTA
TTCGAGACCCG -> TCGAGACCCGC
TTGGGGGGTGC -> TGGGGGGTGCA
AGGGGAGCTCT -> GGGGAGCTCTA
GGGTGCGCCTT -> GGTGCGCCTTT
GCGATACTCTC -> CGATACTCTCA
TGTTCCATCAG -> GTTCCATCAGG
GTAAGGGTACA -> TAAGGGTACAG
TGTGAACTGGT -> GTGAACTGGTT
GCTTCTGAGAA -> CTTCTGAGAAA
GACATCACGAC -> ACATCACGACC
TAAGGGCACTC -> AAGGGCACTCG
CCTTCACAAGA -> CTTCACAAGAT
CCGCAGGTCCG -> CGCAGGTCCGC
TGGGCTGGAGA -> GGGCTGGAGAC
AAGGGCACTCG -> AGGGCACTCGG
ATCTACAAGCG -> TCTACAAGCGG
ATGAGTGTCCG -> TGAGTGTCCGA
CCGATCCGGCT -> CGATCCGGCTC
CCCATAAAACG -> CCATAAAACGA
GAGTAGAAACT -> AGTAGAAACTG
CACACATTCTG -> ACACATTCTGC
GTGGTAGATGG -> TGGTAGATGGG
AACTGGCATAG -> ACTGGCATAGG
GAGTGGACTCT -> AGTGGACTCTA
TCAGCAATAGG -> CAGCAATAGGG
AGGGATACTCT -> GGGATACTCTG
ACTGGTTGGCA -> CTGGTTGGCAA
GCCCTTGAACG -> CCCTTGAACGG
ATCCACGTGCA -> TCCACGTGCAT
TTTAGGGATAC -> TTAGGGATACA
AGAAAAGTGTC -> GAAAAGTGTCT
CGGGAGGCATC -> GGGAGGCATCC
AGAATCTACAA -> GAATCTACAAG
GGCATCCAGAG -> GCATCCAGAGT
GGACTCTAGAA -> GACTCTAGAAC
AAGGTGATACG -> AGGTGATACGA
CCCCAACGGAC -> CCCAACGGACC
GAATCCTTGTT -> AATCCTTGTTG
GCCGGTTCTAG -> CCGGTTCTAGG
CAACGGACCGA -> AACGGACCGAT
GTGATTTAATG -> TGATTTAATGT
CCTGATCCGTA -> CTGATCCGTAC
CTCTGTGGAGT -> TCTGTGGAGTT
GTAGGGTTTAG -> TAGGGTTTAGG
AGGAGGTTAAA -> GGAGGTTAAAG
TGAGGCAATCA -> GAGGCAATCAG
CATTTTCTGTA -> ATTTTCTGTAG
CAAGTTAATCC -> AAGTTAATCCC
CCCCTCGTGGG -> CCCTCGTGGGT
GCTCCCCAAAA -> CTCCCCAAAAT
GCTGCAAGCGT -> CTGCAAGCGTA
TCGGGAGGCAC -> CGGGAGGCACG
GTGGACTCTAG -> TGGACTCTAGA
ACGGTTGGCAA -> CGGTTGGCAAC
CCAAAGATCAA -> CAAAGATCAAT
AACGAGTCACA -> ACGAGTCACAC
CCATGAGTGTC -> CATGAGTGTCC
AGTCCAGGAAT -> GTCCAGGAATA
CCTTGGGGGGT -> CTTGGGGGGTG
CAAGATGCTCT -> AAGATGCTCTG
CTTGAACGGAC -> TTGAACGGACC
AGCACTATAAG -> GCACTATAAGC
CGGCTCAGCGA -> GGCTCAGCGAG
TGTATTCGGTA -> GTATTCGGTAA
ATCCACTCAGC -> TCCACTCAGCA
CGTATTCCGAG -> GTATTCCGAGG
CAAGACATTCC -> AAGACATTCCC
TATCCTAGAAG -> ATCCTAGAAGG
AACGGACCGTA -> ACGGACCGTAT
AGCCATTTCTG -> GCCATTTCTGG
ACGCCAAAGAT -> CGCCAAAGATC
TCCCGTGCTTT -> CCCGTGCTTTT
CTCAGCAATAG -> TCAGCAATAGG
ATGTCAAACTC -> TGTCAAACTCA
GATGGTATTCA -> ATGGTATTCAG
ACGAGTCACAC -> CGAGTCACACT
GAGACGAAAGT -> AGACGAAAGTT
ACCTTTCCTCG -> CCTTTCCTCGG
GGCGGGAGGCA -> GCGGGAGGCAT
TAAGGCCCCCT -> AAGGCCCCCTC
AGTCTTGGCAT -> GTCTTGGCATT
TACATCCACTC -> ACATCCACTCA
CCAATCAATGG -> CAATCAATGGA
ATGGAGGTGTA -> TGGAGGTGTAT
CGGCAGAGCAC -> GGCAGAGCACC
CCACACATTCT -> CACACATTCTG
GTGTCTCTACG -> TGTCTCTACGA
CCCGTGCTTTT -> CCGTGCTTTTC
TAAAACGAGTC -> AAAACGAGTCA
TTTTCCACCGA -> TTTCCACCGAT
GCGGCGCAGTA -> CGGCGCAGTAG
AGCCCACACAT -> GCCCACACATT
CTATAAGCTCG -> TATAAGCTCGC
TGTAATACATT -> GTAATACATTA
ATCTCTTGCGC -> TCTCTTGCGCG
CTACAAGCGGC -> TACAAGCGGCT
CTTTTCCACCG -> TTTTCCACCGA
GTGGCTTAATT -> TGGCTTAATTC
GGCTTAATTTC -> GCTTAATTTCT
CTCTTCCCGCA -> TCTTCCCGCAG
GTGTAGGGTTT -> TGTAGGGTTTA
GCACTCGGGAG -> CACTCGGGAGG
GGGACATGTGA -> GGACATGTGAA
AAAGGAGCCCG -> AAGGAGCCCGC
CCTCAGATAAT -> CTCAGATAATG
ATCCAAGTTAA -> TCCAAGTTAAT
TATATAATATA -> ATATAATATAC
TCGGTGCGATC -> CGGTGCGATCC
CCGTATTCCGA -> CGTATTCCGAG
GACCCGCACCA -> ACCCGCACCAG
CTGCAAGCGTA -> TGCAAGCGTAT
ATGGGTGATTT -> TGGGTGATTTA
GTGAACTGGTT -> TGAACTGGTTG
CGAGTCTCCTT -> GAGTCTCCTTG
TATGGAGGTGT -> ATGGAGGTGTA
TAAGAAACACT -> AAGAAACACTC
GGAGGCATCCA -> GAGGCATCCAG
GTATACGCTTG -> TATACGCTTGT
AAGGGTACAGG -> AGGGTACAGGT
GGCTGCGCGCT -> GCTGCGCGCTA
TATACGCTTGT -> ATACGCTTGTG
ACAGGGGTGCG -> CAGGGGTGCGC
TCTTCCCGCAG -> CTTCCCGCAGG
GGTATCTATCC -> GTATCTATCCT
GACATGTGAAC -> ACATGTGAACA
CTAGAACGGAG -> TAGAACGGAGA
GGGAAGGACGG -> GGAAGGACGGT
ATGTTGTCCCA -> TGTTGTCCCAT
TGTCGGTAAGG -> GTCGGTAAGGA
ATTTCTGGCAC -> TTTCTGGCACC
ATGTCGGGAAA -> TGTCGGGAAAA
CGTTCGGTGCG -> GTTCGGTGCGA
GGGGTGCAAAT -> GGGTGCAAATC
GGGAAAAAATG -> GGAAAAAATGG
CCCTCGTTCGG -> CCTCGTTCGGT
TCAGATAATGC -> CAGATAATGCC
CTCGTTCGGTG -> TCGTTCGGTGC
CACTCTGGGAG -> ACTCTGGGAGT
CCAACGGACCG -> CAACGGACCGA
TGGGGAAGCAT -> GGGGAAGCATT
GGAACGAACTA -> GAACGAACTAC
ACATTCCCGTG -> CATTCCCGTGC
AGTAGCCGAGT -> GTAGCCGAGTC
CAGGAATATCT -> AGGAATATCTA
GCCCGCCTTCA -> CCCGCCTTCAC
GGACCCTTTGC -> GACCCTTTGCT
TCTGAACGGTA -> CTGAACGGTAA
CATCATCTGAA -> ATCATCTGAAG
AACTACCGTCA -> ACTACCGTCAT
TCTACGATATA -> CTACGATATAC
CTGTCTCTGGC -> TGTCTCTGGCC
GTGCATCCCTT -> TGCATCCCTTG
TTTAGGCGGGA -> TTAGGCGGGAA
TAATATACTAG -> AATATACTAGC
CTAGTCTTGGC -> TAGTCTTGGCA
TTTGCGGCGCA -> TTGCGGCGCAG
AGTGTCCGAGA -> GTGTCCGAGAA
TTTCCGGACTC -> TTCCGGACTCC
AATCAGGTTCA -> ATCAGGTTCAT
ACGGGTGAGTG -> CGGGTGAGTGG
TAGAAACTGAG -> AGAAACTGAGT
GACTTTAGGCG -> ACTTTAGGCGG
GATACTCTGAA -> ATACTCTGAAC
CGAAGGCTGCG -> GAAGGCTGCGC
CTGAGTTATAC -> TGAGTTATACG
CCGCACCAGCA -> CGCACCAGCAC
ATATAATATAC -> TATAATATACT
TTATCCAACCT -> TATCCAACCTA
GTAATGGACGC -> TAATGGACGCC
ATACCGGGTAC -> TACCGGGTACA
AGGCCAAGAGG -> GGCCAAGAGGG
GGCATTAAAAG -> GCATTAAAAGG
AGAAACTGAGT -> GAAACTGAGTT
CGCTTGTGTGA -> GCTTGTGTGAA
GTTATCGCGGA -> TTATCGCGGAT
GCAGGTCCGCC -> CAGGTCCGCCC
AAGGACGACGT -> AGGACGACGTG
GGAGCCATTTC -> GAGCCATTTCT
CCCTCAAATGG -> CCTCAAATGGA
GGCAGCGATAC -> GCAGCGATACT
GTTCCTTGGCT -> TTCCTTGGCTC
CACCGATCCGG -> ACCGATCCGGC
TCCATTTTCTG -> CCATTTTCTGT
GCGGACGCCGG -> CGGACGCCGGT
TTCTTCCTTAC -> TCTTCCTTACT
TACCGTCATAG -> ACCGTCATAGT
TAGATGTTGAG -> AGATGTTGAGG
TATCTACCTTT -> ATCTACCTTTC
GTACCAGCGTT -> TACCAGCGTTA
ATTATACCGGG -> TTATACCGGGT
TGGACGCCAAA -> GGACGCCAAAG
GCTTTTCCACC -> CTTTTCCACCG
CTAGGCCCGGG -> TAGGCCCGGGA
GGAGCCCGCCT -> GAGCCCGCCTT
GTAAGGCCCCC -> TAAGGCCCCCT
GGTGATTTAAT -> GTGATTTAATG
GGGTATACGCT -> GGTATACGCTT
GCGGCTGTCTC -> CGGCTGTCTCG
GTAGCCGAGTC -> TAGCCGAGTCG
CCAGAGTAGAA -> CAGAGTAGAAA
TGCTTGTTCCA -> GCTTGTTCCAT
CTTAATGCTTG -> TTAATGCTTGT
GGACTGGATGT -> GACTGGATGTC
CATTTATTTAC -> ATTTATTTACC
GCGTATTGGCT -> CGTATTGGCTC
CTCGCGGATGG -> TCGCGGATGGC
CGCAGGTCCGC -> GCAGGTCCGCC
GATGGCTTTAT -> ATGGCTTTATT
CTTAATTTCTG -> TTAATTTCTGT
TTTCTGTAGTG -> TTCTGTAGTGG
GTGAGCAATCG -> TGAGCAATCGG
TGGGCAGCGAT -> GGGCAGCGATA
ACCAGCACCTC -> CCAGCACCTCA
CGCTAGTCTTG -> GCTAGTCTTGG
TCCAACCTATG -> CCAACCTATGT
CACATTCTGCT -> ACATTCTGCTA
TCAGGAATATC -> CAGGAATATCT
ATCACGACCTA -> TCACGACCTAT
CAGCGTTATCG -> AGCGTTATCGC
CACCTCAGATA -> ACCTCAGATAA
AAAGGGCATAC -> AAGGGCATACT
CGCACTTGCGG -> GCACTTGCGGG
ACATGGCACGT -> CATGGCACGTG
CATTAAAAGGG -> ATTAAAAGGGC
CAATGGATGAC -> AATGGATGACT
CCAACCTATGT -> CAACCTATGTC
GAGCTCTAAAT -> AGCTCTAAATA
CAGTAAAGGAC -> AGTAAAGGACG
ATTAGTGGTAG -> TTAGTGGTAGA
AGGACGGTGGG -> GGACGGTGGGC
GGCTTTATTAC -> GCTTTATTACA
GAGTTATACGG -> AGTTATACGGT
GTGGGCAGCGA -> TGGGCAGCGAT
AAGGGCATACT -> AGGGCATACTG
ACCTCAGATAA -> CCTCAGATAAT
ATTTGCGGCGC -> TTTGCGGCGCA
CCACACTGACA -> CACACTGACAC
CAACTCGTACC -> AACTCGTACCA
ACGTGTAGGGT -> CGTGTAGGGTT
GTAGTTCAACC -> TAGTTCAACCA
TTAGGAGGTGG -> TAGGAGGTGGA
TCAATTCTTCG -> CAATTCTTCGG
GCACCTTGGGG -> CACCTTGGGGG
ATGTTGAGGCA -> TGTTGAGGCAA
TAAGATTCTTC -> AAGATTCTTCC
AAGGCCCCCTC -> AGGCCCCCTCG
TCTTGGCATTA -> CTTGGCATTAA
GGGAGTGAATC -> GGAGTGAATCC
TCACACTGTTG -> CACACTGTTGA
AGTACCGGAAT -> GTACCGGAATG
ATGGCGAAGGT -> TGGCGAAGGTT
TGGCCCAGTAA -> GGCCCAGTAAA
ACCCTGTAGAT -> CCCTGTAGATG
GGTGAGTGGAC -> GTGAGTGGACT
CAACCAGAGGG -> AACCAGAGGGG
GAGATAATCTG -> AGATAATCTGG
CAGCCTGTCTC -> AGCCTGTCTCT
CAATTCTTCGG -> AATTCTTCGGG
CTCTGAACGGT -> TCTGAACGGTA
CGACCTATAAG -> GACCTATAAGA
CGATCCGGCTC -> GATCCGGCTCA
GAGCGATCTGC -> AGCGATCTGCC
AGTTGGGACTT -> GTTGGGACTTT
TCCACGTGCAT -> CCACGTGCATC
GGTATTCAGAT -> GTATTCAGATC
AGGTGAACTCA -> GGTGAACTCAA
GGCTCCGAGTC -> GCTCCGAGTCT
TGGGTGATTTA -> GGGTGATTTAA
CTTGAGGCTTA -> TTGAGGCTTAA
ACTTGCGGGTG -> CTTGCGGGTGA
GCTTTATTACA -> CTTTATTACAT
GGATGGCTTTA -> GATGGCTTTAT
GAGCGGAACGA -> AGCGGAACGAA
GCCTCAGGCAT -> CCTCAGGCATG
TCTAGAACGGA -> CTAGAACGGAG
GCGGTTCCTTG -> CGGTTCCTTGG
GAGTGAATCCT -> AGTGAATCCTT
ATAGTAGCCGA -> TAGTAGCCGAG
GCGGGAGGCAT -> CGGGAGGCATC
CATAGTTGGGA -> ATAGTTGGGAC
GGTACACGAAG -> GTACACGAAGG
TTGGCTTCTGA -> TGGCTTCTGAG
ACTGGATGTCC -> CTGGATGTCCA
CTGTAGATGTT -> TGTAGATGTTG
GAACGTTTGCT -> AACGTTTGCTT
GCGAAGGTTCC -> CGAAGGTTCCT
GGGATAGTGGA -> GGATAGTGGAC
GTTGACGCAGA -> TTGACGCAGAC
CTTGCGGGTGA -> TTGCGGGTGAG
CAGCGAGCGTA -> AGCGAGCGTAT
TTCGGTAATGA -> TCGGTAATGAG
GGTGTATATAA -> GTGTATATAAT
GCCTTTGTAAT -> CCTTTGTAATA
TTTACCAGCCT -> TTACCAGCCTG
GTTGAGGCAAT -> TTGAGGCAATC
GATTCTTCCTT -> ATTCTTCCTTA
GGCGGTCCTTT -> GCGGTCCTTTC
TGTAGATGTTG -> GTAGATGTTGA
GATCCGTACCC -> ATCCGTACCCC
GGGGGAAGGAC -> GGGGAAGGACG
TCATTTATTTA -> CATTTATTTAC
CCTCGGACCCT -> CTCGGACCCTT
CCTGAATTCGG -> CTGAATTCGGG
TGGCTCCCCAA -> GGCTCCCCAAA
TATACCGGGTA -> ATACCGGGTAC
CATCCACTCAG -> ATCCACTCAGC
CTAAGGGCACT -> TAAGGGCACTC
AATTCTTCGGG -> ATTCTTCGGGG
TCGTTCGGTGC -> CGTTCGGTGCG
GCTGGAGACGA -> CTGGAGACGAA
GAACTGGTTGG -> AACTGGTTGGC
TTTCGAGACCC -> TTCGAGACCCG
GCGTTATCGCG -> CGTTATCGCGG
AACCGCCACAC -> ACCGCCACACT
GTGCCGGTTCT -> TGCCGGTTCTA
CCTATGTCGGT -> CTATGTCGGTA
TTAGGCGGGAA -> TAGGCGGGAAG
CAAACTCAGGC -> AAACTCAGGCA
ATAGTGGACCA -> TAGTGGACCAC
CCGAGAATCTA -> CGAGAATCTAC
AGGTTCCTACG -> GGTTCCTACGG
CAGCGCGACCG -> AGCGCGACCGT
AGCTCTAAATA -> GCTCTAAATAC
GTCCAGGAATA -> TCCAGGAATAA
ATAATGCCCGC -> TAATGCCCGCC
TAGGTGGCCGC -> AGGTGGCCGCA
ACGACGTGATT -> CGACGTGATTG
GCTACAACTGG -> CTACAACTGGC
GGGTGCAAATC -> GGTGCAAATCT
CACTGACACCT -> ACTGACACCTG
CGGTGCGATCC -> GGTGCGATCCA
TTGGGACTTTA -> TGGGACTTTAG
ATCATTTATTT -> TCATTTATTTA
ATACTCTCAAA -> TACTCTCAAAT
CTGAACGGTAA -> TGAACGGTAAG
GAGCCATTTCT -> AGCCATTTCTG
TATCATTTATT -> ATCATTTATTT
TGCCGGTTCTA -> GCCGGTTCTAG
GGCATAGGTGG -> GCATAGGTGGC
TCCGCCCTTGA -> CCGCCCTTGAA
TTAATGCTTGT -> TAATGCTTGTT
GGTTAAAGGAG -> GTTAAAGGAGC
TTGGCAGAATC -> TGGCAGAATCA
TACAAGCGGCT -> ACAAGCGGCTG
CAGACCTTAGC -> AGACCTTAGCT
GGGAGCTCTAA -> GGAGCTCTAAA
ATATCTACCTT -> TATCTACCTTT
ACGGGCGGGAG -> CGGGCGGGAGG
CGGATGGTATT -> GGATGGTATTC
TAAGGGTACAG -> AAGGGTACAGG
GCACCTCAGAT -> CACCTCAGATA
GGCCAGGGATA -> GCCAGGGATAC
TCACGACTATC -> CACGACTATCA
AGTAGGCCAAG -> GTAGGCCAAGA
GAATCTCACGG -> AATCTCACGGG
GCGTATGGAGG -> CGTATGGAGGT
TGACGCAGACC -> GACGCAGACCT
ACACTCAGGAA -> CACTCAGGAAT
TACAACCGCCA -> ACAACCGCCAC
CTTGCGATTCA -> TTGCGATTCAC
GCACTATAAGC -> CACTATAAGCT
GACCGATATAG -> ACCGATATAGA
GGCTGTCTCGC -> GCTGTCTCGCA
CCGGGTACACG -> CGGGTACACGA
TACACGAAGGC -> ACACGAAGGCT
GTTCAACCAGA -> TTCAACCAGAG
TCTGGGAGTGA -> CTGGGAGTGAA
GCGAGCGTATG -> CGAGCGTATGG
CAAGCGGCTGT -> AAGCGGCTGTC
GATGGTAGTAA -> ATGGTAGTAAT
TCCTTGGGACA -> CCTTGGGACAT
TGAGTGGACTC -> GAGTGGACTCT
AAAAATGGGGA -> AAAATGGGGAA
GATGTCGTAGT -> ATGTCGTAGTT
TAAATACAACC -> AAATACAACCG
CACGTGCATCC -> ACGTGCATCCC
GCCACACTGAC -> CCACACTGACA
TCTTCCTTACT -> CTTCCTTACTC
TAAGGATGTCG -> AAGGATGTCGG
ATATACTAGCC -> TATACTAGCCC
CGTGCTTTTCC -> GTGCTTTTCCA
GCCGTGGCTTA -> CCGTGGCTTAA
TACCAGCCTGT -> ACCAGCCTGTC
AGGAGGTGGAG -> GGAGGTGGAGA
CGCCAAAGATC -> GCCAAAGATCA
GGCACTCGGGA -> GCACTCGGGAG
TGAACTGGTTG -> GAACTGGTTGG
GGAGATTATCC -> GAGATTATCCA
AGGAATATCTA -> GGAATATCTAC
CCGGACTCCGG -> CGGACTCCGGC
GGCTCCCCAAA -> GCTCCCCAAAA
ATGTGAACAGG -> TGTGAACAGGG
TAAAGGTATCT -> AAAGGTATCTA
TGATACGAACC -> GATACGAACCC
AGCCTGTCTCT -> GCCTGTCTCTG
AGGCTTAATTT -> GGCTTAATTTC
CGGGAGGCACG -> GGGAGGCACGC
GAGGCATCCAG -> AGGCATCCAGA
ATGGTAGTAAT -> TGGTAGTAATG
ACGTGATTGGT -> CGTGATTGGTT
CACCTGATCCG -> ACCTGATCCGT
GCATAGGTGGC -> CATAGGTGGCC
TCAAATCCGCT -> CAAATCCGCTT
CGGTAAGGCCC -> GGTAAGGCCCC
AATCTCACGGG -> ATCTCACGGGC
CTTCGGGGGGA -> TTCGGGGGGAA
CCGGTGCTCCA -> CGGTGCTCCAG
CTCTAAATACA -> TCTAAATACAA
AGACGAAAGTT -> GACGAAAGTTG
GCTACGATGTC -> CTACGATGTCG
TACTAGCCCAC -> ACTAGCCCACA
TAGATGGAGAT -> AGATGGAGATA
TACGGTTGGCA -> ACGGTTGGCAA
AGGTGGAGAAA -> GGTGGAGAAAA
CACGAAGGCTG -> ACGAAGGCTGC
GAGAAAAAGTC -> AGAAAAAGTCC
AATATATAGTA -> ATATATAGTAC
ATGGATGACTT -> TGGATGACTTG
CCAAAATTTGC -> CAAAATTTGCG
CTGTTGCCTAA -> TGTTGCCTAAA
GGCCCGGGACA -> GCCCGGGACAT
AGCATTGGCGG -> GCATTGGCGGT
CGCCCTTGAAC -> GCCCTTGAACG
GATTGGTTGGT -> ATTGGTTGGTT
GGTAAGGCCCC -> GTAAGGCCCCC
ACTCGTACCAG -> CTCGTACCAGC
ACCGGCCAGGG -> CCGGCCAGGGA
CGAACCCTGTA -> GAACCCTGTAG
AACCCTGACCA -> ACCCTGACCAA
CTGAAGAATAT -> TGAAGAATATA
ACTCCGGCAGA -> CTCCGGCAGAG
CGTCATAGTTG -> GTCATAGTTGG
GAAAGTTGCTC -> AAAGTTGCTCG
GCACCAGACGT -> CACCAGACGTA
TACTCTGAACG -> ACTCTGAACGG
GAGGTGTATAT -> AGGTGTATATA
TTCCCGTGCTT -> TCCCGTGCTTT
AATGTTGTCCC -> ATGTTGTCCCA
GCAGCAGACAT -> CAGCAGACATG
GGCTGGAGACG -> GCTGGAGACGA
ATGTCCATTTT -> TGTCCATTTTC
GTATTCGGTAA -> TATTCGGTAAT
ATTCAGATCCA -> TTCAGATCCAT
GGAGAAAAAGT -> GAGAAAAAGTC
CACGACCTATA -> ACGACCTATAA
AAAAGTGTCTC -> AAAGTGTCTCT
GACTCCGGCAG -> ACTCCGGCAGA
CTTGGGGGGTG -> TTGGGGGGTGC
GATGACGCTCC -> ATGACGCTCCT
GGGCGGGAGGC -> GGCGGGAGGCA
ACCCTTTGCTG -> CCCTTTGCTGC
AAATGGAGCCA -> AATGGAGCCAT
TTGTGTGAACT -> TGTGTGAACTG
GCTTAATGCTT -> CTTAATGCTTG
TTAGCTCGTGC -> TAGCTCGTGCC
CAGGAGGTTAA -> AGGAGGTTAAA
GTAATACATTA -> TAATACATTAT
AACTCAAAACG -> ACTCAAAACGG
TTGTCCCATGA -> TGTCCCATGAG
TCCGAGAATCT -> CCGAGAATCTA
TTCTTCGGGGG -> TCTTCGGGGGG
ATTCTTCCTTA -> TTCTTCCTTAC
ATCGGAGAACC -> TCGGAGAACCC
GGCGGGAAGGA -> GCGGGAAGGAT
GCTCGCGGATG -> CTCGCGGATGG
AATATCTACCT -> ATATCTACCTT
TTTTCTGTAGT -> TTTCTGTAGTG
AAGCATTGGCG -> AGCATTGGCGG
ATCAATGGATG -> TCAATGGATGA
ATCCAGAGTAG -> TCCAGAGTAGA
TGATTTCGAGA -> GATTTCGAGAC
CATCACGACCT -> ATCACGACCTA
CGCGGACGCCG -> GCGGACGCCGG
GTAAGGATGTC -> TAAGGATGTCG
TCACGGGCGGG -> CACGGGCGGGA
GTGAACAGGGG -> TGAACAGGGGT
AGATGGGTGAT -> GATGGGTGATT
CAGCACCTCAG -> AGCACCTCAGA
CATTCCCGTGC -> ATTCCCGTGCT
AAGTGCGTAGA -> AGTGCGTAGAC
TACATTAGTGG -> ACATTAGTGGT
GGTACAGGTGA -> GTACAGGTGAA
AGCGCGACCGT -> GCGCGACCGTG
CTGAATTCGGG -> TGAATTCGGGC
ACGTAATTGAC -> CGTAATTGACG
CCGGAATGTGT -> CGGAATGTGTC
GGGACTTGCGA -> GGACTTGCGAT
GGTTTAGGGAT -> GTTTAGGGATA
TAGTTCAACCA -> AGTTCAACCAG
ATGAGCGATCT -> TGAGCGATCTG
TTGGCAATGAG -> TGGCAATGAGC
AAACGGCCTCA -> AACGGCCTCAG
AAGGACGGTGG -> AGGACGGTGGG
TTGGGACATCA -> TGGGACATCAC
AAATCCGCTTA -> AATCCGCTTAA
TTGAGGCAATC -> TGAGGCAATCA
TTCAGCAGCAG -> TCAGCAGCAGA
GCCGGTGCTCC -> CCGGTGCTCCA
GGATGACGCTC -> GATGACGCTCC
GGGGGGAAGGA -> GGGGGAAGGAC
TCTCTAAGGGC -> CTCTAAGGGCA
GGGAGGCACGC -> GGAGGCACGCA
CGCCGGTGCTC -> GCCGGTGCTCC
CTGCCCTCAAA -> TGCCCTCAAAT
TATAGATGGAG -> ATAGATGGAGA
GGATGTCCATT -> GATGTCCATTT
GCCGCAAGGGC -> CCGCAAGGGCT
TGGACTCTAGA -> GGACTCTAGAA
TCCAAGTTAAT -> CCAAGTTAATC
TAAGCTCGCAC -> AAGCTCGCACT
GTAGATGGGTG -> TAGATGGGTGA
AATGTCAAACT -> ATGTCAAACTC
CCTCAGGCATG -> CTCAGGCATGT
CTATCCTAGAA -> TATCCTAGAAG
ACGAACCCTGT -> CGAACCCTGTA
TATACCCCAAC -> ATACCCCAACG
GCCAAGAGGGG -> CCAAGAGGGGC
CGCCTTTGTAA -> GCCTTTGTAAT
CCAGCCTGTCT -> CAGCCTGTCTC
AGTGGGCAGCG -> GTGGGCAGCGA
AATCGGAGAAC -> ATCGGAGAACC
ATACGGTTGGC -> TACGGTTGGCA
GCCTAAAGGTA -> CCTAAAGGTAT
GTCGTAGTTCA -> TCGTAGTTCAA
ATGGCTTTATT -> TGGCTTTATTA
CGGTCCTTTCC -> GGTCCTTTCCG
AGACCTGAATT -> GACCTGAATTC
ACGATATACCC -> CGATATACCCC
CAGATAGTAGC -> AGATAGTAGCC
GTGCTACAACT -> TGCTACAACTG
GCTTCAGGAGG -> CTTCAGGAGGT
GGAGGTTAAAG -> GAGGTTAAAGG
ACCGATATAGA -> CCGATATAGAT
AACCAGAGGGG -> ACCAGAGGGGC
GTATGGAGGTG -> TATGGAGGTGT
AACCTATGTCG -> ACCTATGTCGG
AGGCACGCACC -> GGCACGCACCT
GAAGGTGATAC -> AAGGTGATACG
AAAGGTATCTA -> AAGGTATCTAT
CTTGTTCCATC -> TTGTTCCATCA
ATTTAATGTCA -> TTTAATGTCAA
GCGATCTGCCC -> CGATCTGCCCT
GGTTGGCAATG -> GTTGGCAATGA
TATAAGAAACA -> ATAAGAAACAC
TATTGGCTCCC -> ATTGGCTCCCC
GGGATACAGCG -> GGATACAGCGC
CCCAATGGCGA -> CCAATGGCGAA
ATCCATCATCT -> TCCATCATCTG
CTATGTCGGTA -> TATGTCGGTAA
CGAGAATCTAC -> GAGAATCTACA
TAGGCGGGAAG -> AGGCGGGAAGG
ATTCCGAGGGG -> TTCCGAGGGGA
TCCCGCAGGTC -> CCCGCAGGTCC
AGATGGAGATA -> GATGGAGATAA
TATTCGGTAAT -> ATTCGGTAATG
GGACTTTAGGC -> GACTTTAGGCG
CTTGGGACATC -> TTGGGACATCA
GAGGCTTAATT -> AGGCTTAATTT
AAAACGAGTCA -> AAACGAGTCAC
GTAGACCTGAA -> TAGACCTGAAT
GGAATATCTAC -> GAATATCTACC
GCGGATGGTAT -> CGGATGGTATT
TGGTTCTTAGG -> GGTTCTTAGGA
TGCGATTCACG -> GCGATTCACGA
TGTGGAGTTAC -> GTGGAGTTACC
GGAATAAGTGC -> GAATAAGTGCG
CTCACGGGCGG -> TCACGGGCGGG
GACCCTTTGCT -> ACCCTTTGCTG
CAGGTCCGCCC -> AGGTCCGCCCT
CTTTGTAATAC -> TTTGTAATACA
TTCTGCTACGA -> TCTGCTACGAT
GTAGGCCAAGA -> TAGGCCAAGAG
AGCACCTCAGA -> GCACCTCAGAT
CGACTATCATT -> GACTATCATTT
GACCTGAATTC -> ACCTGAATTCG
ATGCTCTGTGG -> TGCTCTGTGGA
CAGACATGGCA -> AGACATGGCAC
CGGACCCTTTG -> GGACCCTTTGC
GAGACCCGCAC -> AGACCCGCACC
TAGTGGTAGAT -> AGTGGTAGATG
CATAGGTGGCC -> ATAGGTGGCCG
TGCCCTCAAAT -> GCCCTCAAATG
CGTGATTGGTT -> GTGATTGGTTG
GAATATCTACC -> AATATCTACCT
CAGAGCACCAG -> AGAGCACCAGA
GATAGTGGACC -> ATAGTGGACCA
ACACTCTGGGA -> CACTCTGGGAG
GATATAGATGG -> ATATAGATGGA
TAGCCCACACA -> AGCCCACACAT
AAGTCCAGGAA -> AGTCCAGGAAT
AGATCAATTCT -> GATCAATTCTT
TAGCTCGTGCC -> AGCTCGTGCCG
AATGGCGAAGG -> ATGGCGAAGGT
GGGGGGTGCAA -> GGGGGTGCAAA
GGAGGCACGCA -> GAGGCACGCAC
AAGCGTATTGG -> AGCGTATTGGC
GGAGGTGGAGA -> GAGGTGGAGAA
CCTCGTTCGGT -> CTCGTTCGGTG
CAGAGTAGAAA -> AGAGTAGAAAC
GATGTTGAGGC -> ATGTTGAGGCA
ATAGGGGAGCT -> TAGGGGAGCTC
CTTCACAAGAT -> TTCACAAGATG
GTGGAGTTACC -> TGGAGTTACCG
CGGCCTCAGGC -> GGCCTCAGGCA
CGATCCACGTG -> GATCCACGTGC
GCTTGAGGCTT -> CTTGAGGCTTA
TAGTGGACCAC -> AGTGGACCACC
ACTCTAGAACG -> CTCTAGAACGG
GTTCCATCAGG -> TTCCATCAGGC
ATACAGCGCGA -> TACAGCGCGAC
ACTGACACCTG -> CTGACACCTGA
TGGGGGGTGCA -> GGGGGGTGCAA
GCGCGACCGTG -> CGCGACCGTGT
TCTGTGGAGTT -> CTGTGGAGTTA
AGGGGTGCGCC -> GGGGTGCGCCT
AAATCTCTAAG -> AATCTCTAAGG
CTTCAGGAGGT -> TTCAGGAGGTT
GGGAATCTCAC -> GGAATCTCACG
TCCTTTCCGGA -> CCTTTCCGGAC
CGGGGGGAAGG -> GGGGGGAAGGA
CTATCATTTAT -> TATCATTTATT
AGTTCAACCAG -> GTTCAACCAGA
GTACCGGAATG -> TACCGGAATGT
GGCGCAGTAGG -> GCGCAGTAGGC
ATCCTTGTTGG -> TCCTTGTTGGT
GTAATTGACGT -> TAATTGACGTG
TTGTAATACAT -> TGTAATACATT
GACTGGATGTC -> ACTGGATGTCC
TTACCGGCCAG -> TACCGGCCAGG
CGCGGATGGCT -> GCGGATGGCTT
GTCACACTGTT -> TCACACTGTTG
TCTATCCTAGA -> CTATCCTAGAA
CCGCCCTTGAA -> CGCCCTTGAAC
AAGATGCTCTG -> AGATGCTCTGT
TTCCTTGGCTC -> TCCTTGGCTCC
ATCGCGGATGG -> TCGCGGATGGT
GGGACATCACG -> GGACATCACGA
GAGCGTATGGA -> AGCGTATGGAG
CGGGTGAGCAA -> GGGTGAGCAAT
TGCTGCAAGCG -> GCTGCAAGCGT
ACAGCGCGACC -> CAGCGCGACCG
CGTGTATTCGG -> GTGTATTCGGT
CCGTCATAGTT -> CGTCATAGTTG
CTCTCAAATCC -> TCTCAAATCCG
TATAAGCTCGC -> ATAAGCTCGCA
CTGAGAAAAGT -> TGAGAAAAGTG
ACTGAGTTATA -> CTGAGTTATAC
ATGGTATTCAG -> TGGTATTCAGA
CACTCAGCAAT -> ACTCAGCAATA
AACAGGGGTGC -> ACAGGGGTGCG
CCCAGTAAAGG -> CCAGTAAAGGA
GGTGGCCGCAA -> GTGGCCGCAAG
TAATCCCAATG -> AATCCCAATGT
TCGGGGGGAAG -> CGGGGGGAAGG
GGCTTAATTCA -> GCTTAATTCAG
AGCGGAACGAA -> GCGGAACGAAC
ACGAACTACCG -> CGAACTACCGT
CCCGCACCAGC -> CCGCACCAGCA
TTGACGTGTAG -> TGACGTGTAGG
GTTGGTTCTTA -> TTGGTTCTTAG
AACGGTAAGGC -> ACGGTAAGGCC
TTACTCGAACG -> TACTCGAACGT
GGGAAGCATTG -> GGAAGCATTGG
CTCGTGGGTAT -> TCGTGGGTATA
TTAGGGATACA -> TAGGGATACAG
ACCAATCAATG -> CCAATCAATGG
TCCTCGGACCC -> CCTCGGACCCT
GCCCACACATT -> CCCACACATTC
CGCGGATGGTA -> GCGGATGGTAT
GAGGGGCATTG -> AGGGGCATTGG
CTTTAGGCGGG -> TTTAGGCGGGA
ACCTGATCCGT -> CCTGATCCGTA
GTTGGCAACTC -> TTGGCAACTCG
GGAATGTGTCG -> GAATGTGTCGC
GTCTCGCACCG -> TCTCGCACCGC
TTTCCACCGAT -> TTCCACCGATC
TTGTTCCATCA -> TGTTCCATCAG
ACCCAATGGCG -> CCCAATGGCGA
TTGCGCGTTTT -> TGCGCGTTTTG
TCAATGGATGA -> CAATGGATGAC
AGATAATCTGG -> GATAATCTGGT
GTTGTCCCATG -> TTGTCCCATGA
TGACGTGTAGG -> GACGTGTAGGG
TTGTAATATAT -> TGTAATATATC
GAACTACCGTC -> AACTACCGTCA
GAGTCACACTG -> AGTCACACTGT
TCCGAGTCTCC -> CCGAGTCTCCT
GGGTGAGCAAT -> GGTGAGCAATC
TCGTAGTTCAA -> CGTAGTTCAAC
TAATTTCTGTC -> AATTTCTGTCG
TGCGCGCTAGT -> GCGCGCTAGTC
TAATCTGGTAA -> AATCTGGTAAG
GGGGTGCGCCT -> GGGTGCGCCTT
GTCCGAGAATC -> TCCGAGAATCT
TTAATTTCTGT -> TAATTTCTGTC
TGTATATAATA -> GTATATAATAT
AGGTGGCCGCA -> GGTGGCCGCAA
CGTACATCCAC -> GTACATCCACT
AAAGTCCAGGA -> AAGTCCAGGAA
AATAGGGGAGC -> ATAGGGGAGCT
CTGTGGAGTTA -> TGTGGAGTTAC
CCCGCCACACT -> CCGCCACACTG
ACCTTTGTAAT -> CCTTTGTAATA
GTATCTATCCT -> TATCTATCCTA
ACGGACCGTAT -> CGGACCGTATT
TCGAGACCCGC -> CGAGACCCGCA
CACACTGTTGA -> ACACTGTTGAC
AAACGAGTCAC -> AACGAGTCACA
TCTGTAGTGGG -> CTGTAGTGGGC
TCATAGTTGGG -> CATAGTTGGGA
AGGCATCCAGA -> GGCATCCAGAG
GTACACGAAGG -> TACACGAAGGC
AGCGGCTGTCT -> GCGGCTGTCTC
ACGAATCCAAG -> CGAATCCAAGT
CCTTTCCGGAC -> CTTTCCGGACT
ACTATAAGCTC -> CTATAAGCTCG
GTCGCCGGGAT -> TCGCCGGGATA
GCACGCACCTT -> CACGCACCTTA
CTTGATGGTAG -> TTGATGGTAGT
GGTAAGGGTAC -> GTAAGGGTACA
CAGTAGGCCAA -> AGTAGGCCAAG
AAGCTCGCACT -> AGCTCGCACTT
ACCACCCATAA -> CCACCCATAAA
GGCAAGACATT -> GCAAGACATTC
TCGGAGAACCC -> CGGAGAACCCT
CCCTGTAGATG -> CCTGTAGATGT
GGATGTCGGGA -> GATGTCGGGAA
TCGCACCGCGG -> CGCACCGCGGA
TGCTCGCGGAT -> GCTCGCGGATG
GAACGGTAAGG -> AACGGTAAGGC
TCCCCAAAATT -> CCCCAAAATTT
GTGCGCCTTTG -> TGCGCCTTTGT
GGCAACTCGTA -> GCAACTCGTAC
TGACGCTCCTC -> GACGCTCCTCT
TGGGAGTGAAT -> GGGAGTGAATC
CACACTGACAC -> ACACTGACACC
ACTGGCATAGG -> CTGGCATAGGT
TCCATCATCTG -> CCATCATCTGA
TCCTTGGCTCC -> CCTTGGCTCCG
GGGATACTCTG -> GGATACTCTGA
TATCTCTTGCG -> ATCTCTTGCGC
GTCATAGTTGG -> TCATAGTTGGG
GATACTCTCAA -> ATACTCTCAAA
GGACGCCAAAG -> GACGCCAAAGA
ACCGGAATGTG -> CCGGAATGTGT
GACCACCCATA -> ACCACCCATAA
TGTAGTGGGCA -> GTAGTGGGCAG
ATGGACGCCAA -> TGGACGCCAAA
CCCCAAAATTT -> CCCAAAATTTG
TCTAAGGGCAC -> CTAAGGGCACT
GCGGTCCTTTC -> CGGTCCTTTCC
AATGGACGCCA -> ATGGACGCCAA
CAGAGGGGCAT -> AGAGGGGCATT
CTAGAAGGTGA -> TAGAAGGTGAT
GGAAGGATGAC -> GAAGGATGACG
TGGGTATACGC -> GGGTATACGCT
AATGGATGACT -> ATGGATGACTT
TTCTGAGAAAA -> TCTGAGAAAAG
ACCTATAAGAA -> CCTATAAGAAA
ATTCAGCAGCA -> TTCAGCAGCAG
TCCATCAGGCG -> CCATCAGGCGC
CAATGTTGTCC -> AATGTTGTCCC
GCACGTGATTT -> CACGTGATTTC
CTTGGCATTAA -> TTGGCATTAAA
ATACTAGCCCA -> TACTAGCCCAC
TCCAGAGTAGA -> CCAGAGTAGAA
CCGGGATAGTG -> CGGGATAGTGG
CTCAGGCATGT -> TCAGGCATGTC
GAATGTGTCGC -> AATGTGTCGCC
TTTTGGCAGAA -> TTTGGCAGAAT
CGGGCGGGAGG -> GGGCGGGAGGC
TGACTTGGCTT -> GACTTGGCTTC
AGAATATATAG -> GAATATATAGT
CGGGACATGTG -> GGGACATGTGA
GGTGACCTTTG -> GTGACCTTTGT
AATACAACCGC -> ATACAACCGCC
ATCTGAAGAAT -> TCTGAAGAATA
CCTTGTTGGTG -> CTTGTTGGTGA
AAGATTCTTCC -> AGATTCTTCCT
TGTCTCTACGA -> GTCTCTACGAT
CACCCATAAAA -> ACCCATAAAAC
AAAGGACGACG -> AAGGACGACGT
CAAAGATCAAT -> AAAGATCAATT
CTCTAGAACGG -> TCTAGAACGGA
ATTTCTGTCGA -> TTTCTGTCGAC
CCTTAGCTGTT -> CTTAGCTGTTG
CTCGCACTTGC -> TCGCACTTGCG
GCGGATGGCTT -> CGGATGGCTTT
AACGAACTACC -> ACGAACTACCG
AGGTCCGCCCT -> GGTCCGCCCTT
CTGTCGACGTA -> TGTCGACGTAC
CTTGGCTTCTG -> TTGGCTTCTGA
CACCTTAGCTG -> ACCTTAGCTGT
ATCCGGCTCAG -> TCCGGCTCAGC
CCCAATGTTGT -> CCAATGTTGTC
TTAATCCCAAT -> TAATCCCAATG
AGGAGCCCGCC -> GGAGCCCGCCT
CATCAGGCGCC -> ATCAGGCGCCG
TGCTCTGTGGA -> GCTCTGTGGAG
ACTATCATTTA -> CTATCATTTAT
TCATTAAGATT -> CATTAAGATTC
CACGAATCCAA -> ACGAATCCAAG
AGTTACCGGCC -> GTTACCGGCCA
GACATGGCACG -> ACATGGCACGT
TATCCAACCTA -> ATCCAACCTAT
TCTGGCCCAGT -> CTGGCCCAGTA
CGACGTGATTG -> GACGTGATTGG
GAGTCGGACTG -> AGTCGGACTGG
CGGCGCAGTAG -> GGCGCAGTAGG
AGATTATCCAA -> GATTATCCAAC
TTGGGACTTGC -> TGGGACTTGCG
TGGCCGCAAGG -> GGCCGCAAGGG
GGTGAGCAATC -> GTGAGCAATCG
CTAAATACAAC -> TAAATACAACC
AAAAGTCCAGG -> AAAGTCCAGGA
GGTTCATTAAG -> GTTCATTAAGA
TCCACCGATCC -> CCACCGATCCG
AATACATTATA -> ATACATTATAC
GAGCCCGCCTT -> AGCCCGCCTTC
AAATACAACCG -> AATACAACCGC
CAGGTGAACTC -> AGGTGAACTCA
CGTAATTGACG -> GTAATTGACGT
CCGCTTAATGC -> CGCTTAATGCT

